repo_name,commit,file_name,added_functions,hunks_num,added_lines,removed_lines,changed_lines
diofant/diofant,5d04aace44cee50bb1fe1d02e3b866be8ffae7e8,diofant/interactive/printing.py,0,1,1,1,2
PseudoTV/PseudoTV_Live,48f2d7744fe2c1300ce2f6f004b103304606f4f2,plugin.video.pseudotv.live/resources/lib/jsonrpc.py,2,5,3,41,44
merenlab/anvio,a29904ecabb4696f7213506b725872cd1f756c1a,anvio/contigops.py,0,1,1,2,3
DStauffman/dstauffman,5344f6ed74637d17ef9a9bdd74410eca671cb376,dstauffman/estimation/batch.py,0,24,44,49,93
OstapHEP/ostap,518257231cd0bf2857bdf432d9208f44a3af853a,ostap/logger/utils.py,0,3,210,7,217
jeanslack/Videomass,4cfc7d7add47d7217f4825e2cb806d064ff6d176,videomass/vdms_dialogs/filter_stab.py,0,11,74,98,172
pauliacomi/pyGAPS,25a8eafc64d6cb355f423d808e4489cc7caf056a,src/pygaps/parsing/excel.py,0,7,175,119,294
Samsung/TizenRT,34abcb614c4e0461c3d8ceea989c28bd94a187fb,os/tools/set_bininfo.py,0,5,23,8,31
hail-is/hail,75769c4f10d85c756e936323f822304d269ada99,hail/python/hail/stats/linear_mixed_model.py,0,1,1148,3,1151
google/jax,6bb58e6fde0461c980a2a552efd1df96dad0e680,jax/experimental/pjit.py,0,1,1,1,2
nortikin/sverchok,8aea89c4f9831496832d83a23bcf990b33ee568d,nodes/list_mutators/find_closest.py,2,1,53,63,116
openstack/python-openstackclient,9eea28ba59e44526b9d6f1ad9f80c3553d5853e2,openstackclient/image/v2/image.py,0,42,321,191,512
pauliacomi/pyGAPS,25a8eafc64d6cb355f423d808e4489cc7caf056a,src/pygaps/parsing/csv.py,0,6,37,10,47
openatv/enigma2,8887ad79307a939c5b5c955013227c5d007e55c2,lib/python/Screens/Menu.py,1,0,0,0,0
nortikin/sverchok,db9529bdf62cd9874d8124dab604759003b10bc4,core/main_tree_handler.py,0,4,323,5,328
frappe/erpnext,deca1aaf063a3a13404ddc7639e14a0a7bf55ff8,erpnext/stock/doctype/stock_reconciliation/stock_reconciliation.py,0,2,6,21,27
ccxt/ccxt,f868f5bbfbe1a50b08eb93438a1352e5788aa7eb,python/ccxt/digifinex.py,0,4,5,33,38
jjjake/internetarchive,62c85133090e21659f09964fedd4c18ae4a27483,internetarchive/item.py,0,35,142,177,319
klahnakoski/mo-dots,cf7f4007d42de343a76eb42e5846721af11a6fe9,mo_dots/datas.py,0,3,25,6,31
jeanslack/Videomass,f9e0b74e82b9d6ec03f1766f6e030a555e4ff4ba,videomass/vdms_main/main_frame.py,1,22,43,77,120
apache/qpid-dispatch,d8a1f40ebdf198f798745678c78e99d045e3aa74,python/qpid_dispatch_internal/policy/policy_local.py,0,10,20,12,32
catapult-project/catapult,ef16f927e50151533a42c5ecf789c9f75f9f95b3,devil/devil/android/device_utils.py,0,29,78,61,139
wellenvogel/avnav,50f88850067f45de1c8692b1a54e0469a4fbc556,server/handler/alarmhandler.py,12,11,115,243,358
mittagessen/kraken,8829d4457c2dc0ca66a1dca8772e2d390572e342,kraken/lib/train.py,0,1,2,2,4
mittagessen/kraken,69d7db44f6cccec9812a0aadbc7c0a9805802ae8,kraken/lib/train.py,35,7,1050,782,1832
diofant/diofant,5d04aace44cee50bb1fe1d02e3b866be8ffae7e8,diofant/polys/univar.py,0,1,1,1,2
HERA-Team/hera_mc,0844b22238f2af0a2674beb346b0b021841ff35d,hera_mc/watch_dog.py,0,2,84,0,84
lablup/backend.ai-manager,61a3f10a6d8e0305dbc6f33ab65726c6717dea2b,src/ai/backend/manager/api/vfolder.py,0,3,40,37,77
ray-project/ray,6b6d3017badc625d4ec983ef81876cc5ccae2ff7,rllib/evaluation/rollout_worker.py,0,4,15,25,40
frappe/frappe,1cd47222353accf9bcbf403182fb52fc84bdbf7e,frappe/model/delete_doc.py,1,0,0,0,0
frappe/frappe,1a348262034e5b5814c1ee7ab52eeea10fd3c9b4,frappe/model/delete_doc.py,1,0,0,0,0
ccxt/ccxt,f868f5bbfbe1a50b08eb93438a1352e5788aa7eb,python/ccxt/async_support/digifinex.py,0,4,5,33,38
jjjake/internetarchive,9c16ce1e5fe241680b5a469344fd1217d3d53144,internetarchive/session.py,0,22,64,82,146
jjjake/internetarchive,946926a20e47543c83f7a2cd2acc9f33d246b19d,internetarchive/session.py,0,2,9,7,16
isard-vdi/isard,4ed8157288716342c392357a07d747861310770b,api/src/startv3.py,0,1,1,1,2
matrix-org/synapse,4cbcd4a99959a4aaa04c023812f02d9c27e4945f,synapse/storage/databases/main/push_rule.py,0,4,11,5,16
moddevices/mod-ui,af5171dd51c20740ac41adc19214b2f50df7364f,mod/host.py,0,6,22,28,50
diofant/diofant,5d04aace44cee50bb1fe1d02e3b866be8ffae7e8,diofant/polys/polytools.py,0,1,1,1,2
googleapis/python-aiplatform,e21762b703e3f6f45a40e42395b3387eee72141d,google/cloud/aiplatform_v1/services/endpoint_service/client.py,0,4,4,3,7
sergey-dryabzhinsky/dedupsqlfs,15bb1f1af9c56ecfcdf00d9048b32283e78620f0,lib-dynload/_recordclass/lib/recordclass/recordclass.py,1,2,240,72,312
rackerlabs/django-DefectDojo,b36490a4fabad4e10448c486104daa741ec0ee57,dojo/tools/zap/parser.py,0,2,180,43,223
PyCQA/pylint,d3c763285343a307f204e5e5fe5ffabbf070f73c,pylint/utils/file_state.py,1,2,31,40,71
gajim/gajim,d2b1c5c0e6384dbf151a5f80dbf58e9ce14f59cc,gajim/common/modules/adhoc_commands.py,0,0,0,0,0
gem/oq-engine,f87f46e4eefa02d4e404a2636c1b366ff0f9e1cd,openquake/hazardlib/lt.py,0,0,0,0,0
gem/oq-engine,34a8ec432a12621585fdc68581c6df61623c2b93,openquake/hazardlib/lt.py,0,0,0,0,0
awslabs/sockeye,cc7922efc204cb3b2950139969004be6ccf0bdae,sockeye/utils.py,0,9,377,8,385
tensorflow/tensorflow,b4a4a9cebc65d008d5a3484e9e6b5e5df2e33552,tensorflow/python/tpu/tpu_embedding_v2.py,0,3,221,0,221
pantsbuild/pants,c4f9d87bae2f09bfea18141742bae8deaa4748eb,src/python/pants/core/goals/fmt.py,0,3,49,11,60
pymedusa/Medusa,a1fa3e90d768201af8b5589005b5caf81273dabc,medusa/server/web/config/general.py,0,2,154,0,154
DiCarloLab-Delft/PycQED_py3,2411992cd3f74bc0a1bf73afed0eaf48b5d8b4a3,pycqed/instrument_drivers/meta_instrument/LutMans/ro_lutman.py,0,3,1,6,7
DiCarloLab-Delft/PycQED_py3,67d8d0f176137bda8efe84ae36d6495b5debe7c7,pycqed/instrument_drivers/meta_instrument/LutMans/ro_lutman.py,0,4,19,8,27
DiCarloLab-Delft/PycQED_py3,f6414dbb3eb1b598a58ae7c0e0a29422ee403165,pycqed/instrument_drivers/meta_instrument/LutMans/ro_lutman.py,0,3,16,10,26
DiCarloLab-Delft/PycQED_py3,325ecd94b17ae05b453a21564afa11b9580e4510,pycqed/instrument_drivers/meta_instrument/LutMans/ro_lutman.py,0,4,14,7,21
DiCarloLab-Delft/PycQED_py3,f30aa02c1b5687bb302cd6783534e426a6fd5ae6,pycqed/instrument_drivers/meta_instrument/LutMans/ro_lutman.py,0,2,30,9,39
sosreport/sos,2996d4078a28f865c9bf339c62b55c914b336815,sos/report/plugins/networking.py,0,1,46,45,91
sosreport/sos,1d57cdaf45e806fc47233d72add126f89023e08a,sos/report/plugins/networking.py,0,3,42,29,71
jeremiah-c-leary/vhdl-style-guide,ab566beed24815c1dc3bc34f8a8eadb76062c88f,vsg/vhdlFile/code_tags.py,9,1,56,110,166
VROOM-Project/vroom-scripts,cf26d0659afaadb29e60efe8ea31c612edfe18a0,src/plot.py,0,2,38,1,39
huggingface/transformers,319cbbe19153d935f1e706b9bb2e9a294defe9e5,src/transformers/models/deberta_v2/modeling_tf_deberta_v2.py,0,6,28,5,33
googleapis/python-aiplatform,e21762b703e3f6f45a40e42395b3387eee72141d,google/cloud/aiplatform_v1beta1/services/index_service/client.py,0,4,4,3,7
websocket-client/websocket-client,1ec4ccbdfbd2c40662a419c93b83a924e3df85f3,websocket/_http.py,0,1,1,2,3
websocket-client/websocket-client,9adfb69e1e0af80a767874f9248416739e72c742,websocket/_http.py,0,1,3,2,5
matrix-org/synapse,a8db8c6eba8625f8fc224b320be6074d849ceada,synapse/rest/client/sync.py,0,1,8,0,8
guardicore/monkey,8d225b5c1b1da66025e1beaafd512966aed8dc45,monkey/infection_monkey/main.py,0,3,22,2,24
aiven/aiven-client,ff97c2fd5c45149579686f293123b98d3cbd13aa,aiven/client/argx.py,1,14,50,64,114
Keeper-Security/Commander,99fc98289551c67746926d2ed61864ad9b96af42,keepercommander/yubikey/yubikey.py,0,2,22,2,24
Fizzadar/pyinfra,3d425cfe0a87d4fbf85dc624ca5ea0c46b51923d,pyinfra/api/state.py,0,1,14,0,14
jeremiah-c-leary/vhdl-style-guide,c2014549a7c0b9c0a9d90039ce40fbfc98b1e7e0,vsg/vhdlFile/classify/name.py,0,1,21,1,22
catkin/catkin_tools,5f1b46a580a9a1de531c5bee72e0e95cf78b31d1,catkin_tools/verbs/catkin_create/cli.py,0,3,20,0,20
PMEAL/OpenPNM,8036f7d6eac1e5a16e86fb14ff11c2fc39fefe84,openpnm/core/_models.py,1,4,37,10,47
sergey-dryabzhinsky/dedupsqlfs,15bb1f1af9c56ecfcdf00d9048b32283e78620f0,lib-dynload/_recordclass/lib/recordclass/dataclass.py,0,5,134,64,198
ansible/ansible,314bae2a9e26edb42e57aca6ffb4e9e6e1641351,lib/ansible/utils/display.py,0,1,4,7,11
ansible/ansible,6f445ca6e5c9c8b85ccc5062e00508c69ca26fde,lib/ansible/utils/display.py,0,3,12,9,21
project-chip/connectedhomeip,91ea3d50e15ae1670fd31ab7faea4dffed312d2f,scripts/tools/memory/gh_report.py,14,8,587,242,829
lnls-fac/pyaccel,8a86289875a71f6a4978f6bceea6ef7bf1c00f3f,pyaccel/lattice.py,1,3,49,97,146
kizniche/Mycodo,8a98702eb6d45d25a73c7a7336bc15dfddd935d9,mycodo/utils/influx.py,0,13,433,176,609
tensorflow/federated,d24a223b8ee7ec85efec00494242ad725d1626de,tensorflow_federated/python/simulation/iterative_process_compositions.py,1,4,35,92,127
openstack/ironic,dbcce25d3840a06ea83d5f76ca90d55c2a0ac629,ironic/drivers/modules/irmc/inspect.py,0,2,3,3,6
wagtail/wagtail,1357960c8609db04589998b548c8ebd69ad15af0,wagtail/admin/action_menu.py,0,7,141,11,152
respawner/peering-manager,4325ea793f5c1fcd35709b8576574ef7b63c7589,utils/views.py,4,3,709,48,757
googleapis/python-aiplatform,e21762b703e3f6f45a40e42395b3387eee72141d,google/cloud/aiplatform_v1beta1/services/vizier_service/client.py,0,4,4,3,7
yeatmanlab/pyAFQ,526b689f25ff2ddd12a8c588d2cb1c4dda8a253b,AFQ/tasks/viz.py,0,2,21,3,24
ligo-cbc/pycbc,1fe198f79681f968c4d771fe322181b1a17bda0b,pycbc/results/pygrb_plotting_utils.py,0,5,552,34,586
OCA/bank-statement-import,992e383f4c02163dd1b40df266d0ac08407821d3,account_statement_import_online_ponto/models/online_bank_statement_provider_ponto.py,0,1,24,22,46
tomerfiliba/plumbum,72e8c1dbac47f93e714ff36f6b50f16f5e0e8571,plumbum/machines/session.py,0,5,24,19,43
isard-vdi/isard,d0ea9310fd387e1714be57ad992c487f87e320ba,api/src/api/views/DesktopsPersistentView.py,0,3,206,3,209
acorg/dark-matter,1dd4ebfcba81042182d21b339497b97c490266b2,dark/consensus.py,2,1,91,74,165
acorg/dark-matter,e20d18eb697c3158e9a6194c77b6ce11c8c72982,dark/consensus.py,1,13,96,31,127
pantsbuild/pants,960f12f2da2ef2c1d8b0d4fc1bd64336a282ff8d,src/python/pants/backend/python/target_types_rules.py,0,2,5,14,19
zentralopensource/zentral,1b04faf679088a0bab6bd15d9d0d1b965c6a3b06,zentral/contrib/inventory/tasks.py,5,6,35,55,90
googleapis/python-aiplatform,4ddc426a6b4b8cd319fa885e363c94b35ef777d9,google/cloud/aiplatform_v1beta1/services/job_service/client.py,0,33,527,245,772
googleapis/python-aiplatform,e21762b703e3f6f45a40e42395b3387eee72141d,google/cloud/aiplatform_v1beta1/services/job_service/client.py,0,4,4,3,7
fabioz/PyDev.Debugger,51f4ae23c75dfac83d8d22a6a197a94f126a92d2,_pydevd_bundle/pydevd_net_command.py,0,3,16,6,22
biorack/metatlas,53b5f4458cfa4f3b23b3256a6ee16e99addbeeba,metatlas/io/file_converter.py,5,1,150,197,347
psy0rz/zfs_autobackup,2ffd3baf772c91b6c8bc699cbef66b4c01c1487a,zfs_autobackup/CmdPipe.py,2,5,48,73,121
HumanCompatibleAI/imitation,f9475c5168592259642adf600f288afae7190dcf,src/imitation/scripts/train_preference_comparisons.py,0,8,86,6,92
demisto/content,22efaa578953685beb3dd553cc4ec8ecfafb0e3e,Packs/BitSight/Integrations/BitSightForSecurityPerformanceManagement/BitSightForSecurityPerformanceManagement.py,8,8,316,380,696
seleniumbase/SeleniumBase,5690d4225687c01ddb3afbc823d95111d4449201,seleniumbase/core/report_helper.py,0,2,55,6,61
Ultimaker/Cura,d7c24f8bea29fd161b600a2a78751cda06af163a,plugins/RemovableDriveOutputDevice/RemovableDriveOutputDevice.py,1,1,0,12,12
gemrb/gemrb,bb1024c881173c35e3e89cd550d370d94cd4d5ad,gemrb/GUIScripts/GUISAVE.py,0,1,24,21,45
googleapis/python-aiplatform,e21762b703e3f6f45a40e42395b3387eee72141d,google/cloud/aiplatform_v1/services/pipeline_service/client.py,0,4,4,3,7
rwightman/pytorch-image-models,41dc49a33752b72dbb3cff5cb181b9953e07971f,timm/models/vision_transformer.py,7,27,82,108,190
lutris/lutris,d7151f04c640815648bc7fa6713c65f234ecc3b7,lutris/services/gog.py,0,4,7,9,16
lutris/lutris,7453cdb5dd72ce4d9d25bff58b7745605822cb03,lutris/services/gog.py,5,5,9,74,83
quantumlib/Cirq,6e52f54a01b7f41e376642a38f4e63c159eed912,cirq-google/cirq_google/devices/known_devices.py,0,3,141,1,142
google/turbinia,4fcab02e8109896841f160678d7db552ad9dab4f,turbinia/workers/partitions.py,1,6,13,27,40
awslabs/sockeye,cc7922efc204cb3b2950139969004be6ccf0bdae,sockeye/model.py,5,18,312,289,601
kivy/kivy,edf0093b02a3c9b314087eef2caeb754aede85fc,kivy/uix/bubble.py,1,0,0,0,0
kivy/kivy,1717a414c837fd08adb68158e27d451c67d465c6,kivy/uix/bubble.py,10,6,267,356,623
pantsbuild/pex,3e71bc7896935a8177e9bbe9399769c3522528dc,pex/jobs.py,0,13,28,57,85
google/qkeras,72bd21eca599b915283ebd2e3a6c3e86c96b2331,qkeras/qtools/qenergy/qenergy.py,0,6,20,17,37
anselmobd/fo2,66d0bccae24ac60769775753246e1e2c82a995c5,src/geral/views/views.py,0,1,81,0,81
mesonbuild/meson,c42a3fd2fbefce7797766f81f14b89ef0e4c5dcc,mesonbuild/modules/cmake.py,0,0,0,0,0
espressif/esp-idf,d50f021a8cf9bea290f616f0d20157206aceaa21,components/espcoredump/espcoredump.py,0,3,1440,167,1607
espressif/esp-idf,528cdc15463b87360f6351cc613674c7bd2c07e2,components/espcoredump/espcoredump.py,1,3,325,23,348
mapillary/OpenSfM,9268047c9763a58a4985b51a01b516c8823591db,opensfm/exif.py,0,3,45,18,63
ray-project/ray,4a15c6f8f3ebb634f7cef967a097f621462e4e50,python/ray/tune/schedulers/resource_changing_scheduler.py,20,14,101,595,696
bazelbuild/bazel,a2766230f319155548b53d6d0672b79b150c6702,tools/build_defs/pkg/build_tar.py,0,3,13,1,14
fabioz/Pydev,86af32cce78906d1e5a3abb65d35da4f7a75d487,plugins/org.python.pydev.core/pysrc/pydev_coverage.py,0,4,13,11,24
fabioz/Pydev,89c9e747e052957de792eef2127b6574db1aa2be,plugins/org.python.pydev.core/pysrc/_pydevd_bundle/pydevd_net_command.py,0,3,16,6,22
rackerlabs/django-DefectDojo,e2a2177c3439b4243dc1c7944a48e4e90d259bc5,dojo/tools/sarif/parser.py,4,3,39,92,131
pauliacomi/pyGAPS,571354901e306900031e9d15572863b3d40f5faf,src/pygaps/characterisation/area_bet.py,0,4,63,76,139
pauliacomi/pyGAPS,bf2c389d2c5fe5889eb705f841a090cf9ba21c20,src/pygaps/characterisation/area_bet.py,1,10,57,69,126
syncle/syncle.github.io,af35bb96d63d3d6563083943b2c0cf4cf8e1644e,script/gen_publication_html.py,0,3,25,21,46
google/qkeras,39dc01d9a832b7661aa06dd3600b052756d3fcf4,qkeras/qtools/interface.py,0,1,75,63,138
spulec/moto,19fef76a5faa8cc5e6df5e82a40016f8b4ad91f6,moto/server.py,1,3,13,37,50
spulec/moto,5de95b026ac7474d8edbce20666531388babc912,moto/server.py,1,3,19,20,39
spulec/moto,c9dd9cc7f9ffe6de600a39fbf028db805ed4a0c2,moto/server.py,0,3,5,8,13
spulec/moto,dc5353f1aeedbd4c182ed3ce3e3e90acd555e154,moto/server.py,0,1,319,7,326
googleapis/python-aiplatform,e21762b703e3f6f45a40e42395b3387eee72141d,google/cloud/aiplatform_v1beta1/services/tensorboard_service/client.py,0,8,13,15,28
lowRISC/opentitan,787095948c63633702b64cb9fa34a601258f22ca,hw/ip/otbn/dv/otbnsim/sim/state.py,2,6,71,31,102
pytransitions/transitions,e83b4d3a42ebfae198ac07f32e1f8f5cb90adb7a,transitions/extensions/nesting.py,5,5,104,122,226
Neutree/COMTool,140afa7baa5c0feed803ad22e0fa3919f166c07d,COMTool/Main.py,12,17,1107,214,1321
Neutree/COMTool,3203497f67a0440ab5a534c89de5207499b6f0de,COMTool/Main.py,0,1,1032,14,1046
virt-manager/virt-manager,8377b7f7b69ed0716fbe2c2818979a273bcb7567,virtManager/device/addstorage.py,0,8,19,1,20
pantsbuild/pants,5e021322ffe92f541a626288b47ccc4ecfa30988,src/python/pants/base/specs_parser.py,0,2,26,31,57
pimutils/khal,021c6f6ebb2defe64e9c4b4800c5f5d1e11c507c,khal/settings/utils.py,0,3,29,18,47
PMEAL/OpenPNM,6eeb8d5d793650edf0296fa6cdf59ed41a783c6f,openpnm/io/_dict.py,0,6,97,17,114
Maselkov/GW2Bot,da0c4dc4213bade7f5f7c277ce718319f4a0901b,guildwars2/commerce.py,1,8,149,108,257
googleapis/python-aiplatform,4ddc426a6b4b8cd319fa885e363c94b35ef777d9,google/cloud/aiplatform_v1beta1/services/dataset_service/client.py,0,20,308,125,433
googleapis/python-aiplatform,e21762b703e3f6f45a40e42395b3387eee72141d,google/cloud/aiplatform_v1beta1/services/dataset_service/client.py,0,4,4,3,7
rapydo/do,19801b2bd3c4d46c4ac05e14d48e6c462588ff0e,controller/utilities/services.py,0,5,22,5,27
Giswater/giswater_qgis_plugin,bab4b0b30526eecaf947c1ff4c5a8b957c03044b,core/threads/project_layers_config.py,0,3,141,2,143
zephyrproject-rtos/zephyr,dc6b51a52d8216d99a4f1650a96434c7816ec385,scripts/logging/dictionary/log_parser.py,1,3,17,31,48
mpi4py/mpi4py,85ba75defe0e73dd86c00b54745fccf4b5831cc1,conf/cythonize.py,0,2,37,27,64
googleapis/python-aiplatform,e21762b703e3f6f45a40e42395b3387eee72141d,google/cloud/aiplatform_v1/services/model_service/client.py,0,4,4,3,7
psychopy/psychopy,0666040304552a3757059f306a2ebe1f76206daf,psychopy/core.py,0,0,0,0,0
psychopy/psychopy,877f712c137332ef0c41fa62fa5fad105f56733a,psychopy/core.py,0,0,0,0,0
metabrainz/listenbrainz-server,0eb3ef684ef65fa7743d55ecd31b159a0ac2bd3f,listenbrainz/listenstore/timescale_utils.py,2,4,89,117,206
EducationalTestingService/rsmtool,f6fa9813c3d18e7d1986cf8a2f0aaa1249ce5d21,rsmtool/writer.py,1,3,27,57,84
EducationalTestingService/rsmtool,b86256ce9d2582a147f13ef10fd800dda89f0d4e,rsmtool/writer.py,0,7,20,18,38
astropy/photutils,2737cb56940079bb98e2e5a9a14b56c9f9627b36,photutils/segmentation/detect.py,0,5,31,33,64
genialis/resolwe-bio,561670c802ca9f377a312c8c57edbf783b98d1bb,resolwe_bio/processes/reads_processing/markduplicates.py,0,5,39,1,40
timcera/tsgettoolbox,750cb15418f276eb831d4d4517515ee94191802c,src/tsgettoolbox/ulmo/cpc/drought/core.py,0,4,2,5,7
candlepin/subscription-manager,78b720c5e2c409d6a8c2aa2f34dcb77b5f3ba225,src/subscription_manager/cli_command/status.py,4,5,13,72,85
facelessuser/ColorHelper,2365d8b9b5e8f1054c575818bf4a1684d2f9d121,lib/coloraide/spaces/srgb/css.py,0,3,194,19,213
lablup/backend.ai-manager,00fbe414333793e2107441086f639070654e2111,src/ai/backend/manager/config.py,0,5,248,2,250
tobi-wan-kenobi/bumblebee-status,771e7482d719994e72a0381d449ecc54cf342342,bumblebee_status/modules/contrib/playerctl.py,2,3,3,12,15
jeremiah-c-leary/vhdl-style-guide,7225df8b9db9eb5b210c8b41597ad1d64eed5c3b,vsg/vhdlFile/classify/subtype_indication.py,0,1,38,8,46
eljost/pysisyphus,ad4a77cd8a18ae35c2ab7cd2a9d58d5611a63468,deprecated/optimizers/ONIOMOpt.py,1,1,260,94,354
openstack/tacker,e2db1c7a4032d316e5b655b858b023ace8435cd8,tacker/vnfm/infra_drivers/kubernetes/k8s/translate_outputs.py,1,5,178,29,207
hyperspy/hyperspy,fa84384897ed504c981af6dcc0d73ec180cb1002,hyperspy/_components/power_law.py,0,3,8,7,15
arviz-devs/arviz,422c00b3cc24f3983bea283396bff0195374dcc3,arviz/plots/traceplot.py,0,4,231,50,281
arviz-devs/arviz,4c9fb4f32af76a792c500fc76f8bfe4cbafcc9ec,arviz/plots/traceplot.py,0,6,84,2,86
arviz-devs/arviz,b2b9cbc459c1ae9cafff4f3561f8481343a67c8d,arviz/plots/traceplot.py,0,1,4,1,5
openstack/neutron,f7fac03ae1a4b1b1471f6054ba058382a1b9e1a1,neutron/agent/linux/interface.py,2,2,17,53,70
googleapis/python-aiplatform,e21762b703e3f6f45a40e42395b3387eee72141d,google/cloud/aiplatform_v1/services/specialist_pool_service/client.py,0,4,4,3,7
googleapis/python-aiplatform,e21762b703e3f6f45a40e42395b3387eee72141d,google/cloud/aiplatform_v1/services/migration_service/client.py,0,5,13,12,25
couchbase/couchbase-python-client,6d305796b094024c2ea07c8c963899999420f610,couchbase/management/queries.py,21,13,489,141,630
googleapis/python-aiplatform,4ddc426a6b4b8cd319fa885e363c94b35ef777d9,google/cloud/aiplatform_v1beta1/services/prediction_service/client.py,0,8,177,44,221
googleapis/python-aiplatform,e21762b703e3f6f45a40e42395b3387eee72141d,google/cloud/aiplatform_v1beta1/services/prediction_service/client.py,0,4,4,3,7
OCHA-DAP/hdx-python-api,cadfcb090c288b8925076e6140c5b22aad85e45f,src/hdx/data/resource.py,0,3,258,0,258
googleapis/python-aiplatform,e21762b703e3f6f45a40e42395b3387eee72141d,google/cloud/aiplatform_v1beta1/services/featurestore_service/client.py,0,5,5,4,9
isard-vdi/isard,73f16b09b7032a855cd7c71f115ae25f756dc212,api/src/api/libv2/api_desktops_persistent.py,1,4,181,94,275
digitalocean/netbox,00a8fd654eb4eab47972c3ad7ca2b5bc6752d3e4,netbox/utilities/tables.py,0,0,0,0,0
SasView/sasmodels,69ec80f641366fc1c80fed9bcfff0d283905e6ef,sasmodels/data.py,1,14,108,111,219
SasView/sasmodels,9d70932f0a036297ae0371e58a6ab4edd06a3541,sasmodels/data.py,1,15,18,60,78
mrachinskiy/jewelcraft,53791c3c6e0564cb7bbb79a524cedf69db7dc9a0,op_design_report/report_get.py,0,2,13,2,15
jeremiah-c-leary/vhdl-style-guide,41b0a3704fc9e916294547ea0350a6d37104048a,vsg/rules/constant/rule_014.py,2,2,104,23,127
rackerlabs/django-DefectDojo,a51e7f9ce7b54387df1f78579d2645df72ac9b8c,dojo/tools/wpscan/parser.py,1,3,42,57,99
openzim/zimfarm,ff81bc3c0e5cad8aec461d5bd9a40679362fe20d,dispatcher/backend/src/utils/offliners.py,0,3,30,35,65
couchbase/couchbase-python-client,73bf1e22d61d14a4fbd6336d569b9149fbf48e94,couchbase/exceptions.py,6,10,174,39,213
pandas-dev/pandas,59b275c1dc63c5422495cf4d1564b674a32f4d77,pandas/core/indexes/period.py,0,3,29,2,31
pandas-dev/pandas,b678ecac30c629e215190f6001b3519feb9f1046,pandas/core/indexes/period.py,0,5,19,1,20
pandas-dev/pandas,9a00692ca757a6380b99fd544d25b8d95ab16241,pandas/core/indexes/period.py,3,6,29,44,73
pandas-dev/pandas,c43727711067e474857005cb7669fcec6552cac2,pandas/core/indexes/period.py,0,5,77,10,87
fabioz/Pydev,89c9e747e052957de792eef2127b6574db1aa2be,plugins/org.python.pydev.core/pysrc/_pydevd_bundle/pydevd_safe_repr.py,0,3,50,2,52
django-crispy-forms/django-crispy-forms,6477527efbf9943140478595d2ef6211d56ed8ae,crispy_forms/helper.py,0,2,14,12,26
googleapis/python-aiplatform,4ddc426a6b4b8cd319fa885e363c94b35ef777d9,google/cloud/aiplatform_v1beta1/services/specialist_pool_service/client.py,0,13,227,72,299
googleapis/python-aiplatform,e21762b703e3f6f45a40e42395b3387eee72141d,google/cloud/aiplatform_v1beta1/services/specialist_pool_service/client.py,0,4,4,3,7
benvanwerkhoven/kernel_tuner,4e4313df6ae7011f6adef3f10f50d594879e040e,kernel_tuner/strategies/hillclimbers.py,2,2,166,48,214
benvanwerkhoven/kernel_tuner,3c008a5adc4d6c766516a18b368105386acc937c,kernel_tuner/strategies/hillclimbers.py,0,4,51,33,84
mozilla-services/tecken,a586325c8fee3ef0623e4660795451e08908255e,tecken/api/views.py,5,4,38,81,119
tensorflow/tensorflow,2f068c31f44813a48086cb44a9aea6dae5273371,tensorflow/python/data/ops/multi_device_iterator_ops.py,0,8,87,13,100
deepmind/dm_control,662a3ce7befdc5f3bb17186ca5f9a9d8aa4f522a,dm_control/autowrap/autowrap.py,0,3,23,0,23
akrherz/pyIEM,f257b6bc888ae25afafaab00541fa548d4d5e397,src/pyiem/windrose_utils.py,1,12,160,130,290
googleapis/python-aiplatform,4ddc426a6b4b8cd319fa885e363c94b35ef777d9,google/cloud/aiplatform_v1beta1/services/model_service/client.py,0,20,305,126,431
googleapis/python-aiplatform,e21762b703e3f6f45a40e42395b3387eee72141d,google/cloud/aiplatform_v1beta1/services/model_service/client.py,0,4,4,3,7
ray-project/ray,d83bbda2816b1781eb61342b4539578149eeb686,rllib/policy/tf_policy.py,0,2,22,2,24
gajim/gajim,8b35d0545287d8778f9fcc6f4a27e9f3ccab84d7,gajim/gtk/search_view.py,0,10,74,10,84
OCA/l10n-romania,eb707db04caab1f80a39a676eb02518f23703b6f,l10n_ro_stock_account/models/stock_move.py,0,10,158,1,159
OCA/l10n-romania,7e59dea2b7a0388553205a316ce3c4e0a13ad6bf,l10n_ro_stock_account/models/stock_move.py,0,0,0,0,0
wikimedia/pywikibot-core,e317d52cc2b53217462ad0525d3d6c15dfde0d92,scripts/add_text.py,0,2,213,3,216
spesmilo/electrum,a4f5cfc91a8904c8fb9c2c60fc06a1cd1b6f5227,electrum/trampoline.py,3,5,98,93,191
googleapis/python-aiplatform,e21762b703e3f6f45a40e42395b3387eee72141d,google/cloud/aiplatform_v1beta1/services/index_endpoint_service/client.py,0,4,4,3,7
explosion/thinc,522aff0243a625a1a460333a528903abdccd6825,thinc/layers/chain.py,0,0,0,0,0
explosion/thinc,f6eee9a810190d14770eb1f31072e4e09c76a10a,thinc/layers/chain.py,0,5,18,20,38
DiCarloLab-Delft/PycQED_py3,f41d7785ea96c68e2b400ee791f8d93bd8b571cf,pycqed/instrument_drivers/meta_instrument/HAL/HAL_ShimSQ.py,38,0,0,0,0
coreboot/chrome-ec,b54655a55feb3d98dbad7e23965d953d8326186d,zephyr/zmake/zmake/zmake.py,1,2,19,33,52
coreboot/chrome-ec,205bf7ab0a862acff1ba964483c651b86e8406e5,zephyr/zmake/zmake/zmake.py,0,28,56,65,121
coreboot/chrome-ec,143369c812eed703f9576a362b45bc8f104c7aa8,zephyr/zmake/zmake/zmake.py,2,4,344,331,675
all-of-us/raw-data-repository,e8d8ff76a14ceadabfca6666fd2f00f0740fa05b,rdr_service/resource/generators/consent_metrics.py,6,8,169,193,362
streamlink/streamlink,ad8cf544236a420808111efeec6122d8a41467e5,src/streamlink/plugins/rtve.py,12,1,134,153,287
NaturalHistoryMuseum/ckanext-nhm,89f712275574dd19807f3fc50b8502b0ebcf9664,ckanext/nhm/routes/record.py,2,3,147,57,204
matrix-org/synapse,acda9f07c858902ab072d49f6ad3e26df874d06e,synapse/rest/client/push_rule.py,0,3,11,2,13
timcera/tsgettoolbox,777201b2e04fd5af1315791e0ee3636b3cabdde1,src/tsgettoolbox/appdirs.py,0,2,2,1,3
Geoportail-Luxembourg/geoportailv3,5f919ee341e7a79260f1dbba16b2425266b13cc7,geoportal/geoportailv3_geoportal/views/routing.py,1,1,24,15,39
kobotoolbox/kobocat,f5d76adb10f371001a8204dd399b73c89d6faa3d,onadata/apps/logger/views.py,0,13,129,46,175
numba/numba,0310683759e62e378ec184a31e419b803e23ab93,numba/cuda/compiler.py,6,5,2,45,47
numba/numba,d40946cb9f668b89a310433f053bdb406b839d4b,numba/cuda/compiler.py,0,4,366,1,367
isard-vdi/isard,5075b0825ba34972f87ca7b1f576a7eff37a4117,api/src/api/views/VpnViews.py,0,2,97,26,123
mdiller/MangoByte,13ab3b6851d0547d4babde81b2637f1d9440c397,cogs/admin.py,0,0,0,0,0
mdiller/MangoByte,3d7c61cc891c400bb5ed7502b92eb3a603819516,cogs/admin.py,0,3,65,4,69
mdiller/MangoByte,ee8c90701d8c8e909f11eabe7fa4d79929c3c33f,cogs/admin.py,0,3,144,61,205
dart-lang/sdk,c9d2394c02f6c1870eb1737cc643dc786a93ef75,tools/linux_dist_support/create_debian_packages.py,0,4,11,1,12
tweepy/tweepy,86244c1a82a1852d04f3695b03201363f5d5eafd,tweepy/client.py,7,4,58,73,131
opencobra/cobrapy,b628572aa0a8d35825acbd1502cdf0b8e1023bbc,src/cobra/manipulation/delete.py,1,4,150,50,200
Rapptz/discord.py,92d1b4cd2b8cda4bb7f9c39acbf868ee66afaec0,discord/interactions.py,0,11,61,51,112
rackerlabs/django-DefectDojo,e045e93c4e28c7414dcd42fbb6d8311da02ba385,dojo/management/commands/migrate_authorization_v2.py,0,2,78,5,83
metabrainz/acousticbrainz-server,b8c8a5cf06df0151013c68491767f370521c4902,db/dump.py,0,1,36,22,58
metabrainz/acousticbrainz-server,7987ffadb63deb6abd6ea80d849508169ca105f9,db/dump.py,0,5,98,29,127
metabrainz/acousticbrainz-server,2431dff25f853fa952ce0d0efe8c2d7330c244d6,db/dump.py,0,2,40,29,69
metabrainz/acousticbrainz-server,3c419eb150ea7bd70a91431c82ccd1e6d5c28b56,db/dump.py,0,6,54,16,70
ligo-cbc/pycbc,11142c548ee91c37c8819a2f5e81b65f78eac873,pycbc/workflow/tmpltbank.py,0,6,63,2,65
catapult-project/catapult,930212befd67a390976fd9dfc5211aacb4446534,dashboard/dashboard/pinpoint/models/quest/read_value.py,0,1,6,2,8
catapult-project/catapult,e999681ef89091d15a27b9dc74ae24b799db282a,dashboard/dashboard/pinpoint/models/quest/read_value.py,3,10,13,32,45
makcedward/nlpaug,6f6e044dfc49b155b2642767428d7532d4a1f0e9,nlpaug/flow/pipeline.py,0,3,16,8,24
giampaolo/psutil,54c0648bd1d7552d27c577d65f70c25023001071,scripts/internal/git_pre_commit.py,0,1,4,4,8
giampaolo/psutil,e7ba381b77d24cdfbd1a1a8df9acd02db8e81e54,scripts/internal/git_pre_commit.py,5,3,33,54,87
NeuralEnsemble/python-neo,136e80004e5978a6bc0dc6ea1eeec9204629cea5,neo/io/alphaomegaio.py,0,1,653,7,660
scikit-learn/scikit-learn,138e0557110ffce4175b7f18a683a939e118790a,sklearn/semi_supervised/_self_training.py,0,3,15,15,30
mozilla/kitsune,4703755e269c76c90555c94276f14370b2b92e5c,kitsune/questions/forms.py,0,1,14,0,14
googleapis/python-aiplatform,e21762b703e3f6f45a40e42395b3387eee72141d,google/cloud/aiplatform_v1beta1/services/migration_service/client.py,0,4,4,3,7
engineervix/Bible-Playlist-Generator,ed7621a41281c61103c79cbc181e5aa89c3cf147,tenlists/cli/__main__.py,1,2,287,23,310
Maselkov/GW2Bot,da0c4dc4213bade7f5f7c277ce718319f4a0901b,guildwars2/wallet.py,1,6,63,51,114
mozman/ezdxf,5e3c51e593651f0add822a64c7224ef5e476c4da,src/ezdxf/math/_construct.py,0,2,59,30,89
GoogleCloudPlatform/gcpdiag,dc2d39b66f9b46d49d056a8e9afffb49af606595,gcpdiag/lint/command.py,2,6,65,76,141
tensorflow/similarity,60e7c7b541e61e756dbaf7c9051e3dd0c9dd116e,tensorflow_similarity/evaluators/memory_evaluator.py,4,4,124,154,278
gboeing/osmnx,2bad443e7476b8878a5cb80118dc0b41150e11cc,osmnx/elevation.py,0,6,31,8,39
geodynamics/burnman,130b943c0a29a5ee8f329c266076be9874cb45d8,burnman/classes/composition.py,3,7,185,144,329
radiasoft/pykern,1afc867ba75d6028059ff680c35470c4d6854d91,pykern/pkunit.py,12,4,99,144,243
metabrainz/listenbrainz-server,804836d2c96c191047844e7bf2a5998a3442cd03,listenbrainz/db/dump.py,0,3,14,1,15
metabrainz/listenbrainz-server,a8b9f401b41ec19c6887caa11dabc1fff243f39f,listenbrainz/db/dump.py,0,2,85,14,99
demisto/content,dfef91d5570760677223516e0fe6564afa147539,Packs/Cybersixgill-ActionableAlerts/Integrations/CybersixgillActionableAlerts/CybersixgillActionableAlerts.py,2,7,53,79,132
indico/indico,6482376e847e0336595d9e78a56f393d4eee27b7,indico/modules/auth/controllers.py,1,8,41,56,97
indico/indico,5148d30bdd312c289b1dc6524dcd73ead995eece,indico/modules/auth/controllers.py,13,11,121,239,360
fabioz/PyDev.Debugger,47e298499ef19563bb2ef5941a57046a35ae6868,pydev_coverage.py,0,4,13,11,24
googleapis/python-aiplatform,e21762b703e3f6f45a40e42395b3387eee72141d,google/cloud/aiplatform_v1beta1/services/featurestore_online_serving_service/client.py,0,4,4,3,7
spaam/svtplay-dl,be21f7d695902e7373a4d7fa28e810eb9f2648d9,lib/svtplay_dl/service/tv4play.py,0,3,44,31,75
spaam/svtplay-dl,6ebdf50d71aca0fa3e7713ee7a7a0a91bb8cc688,lib/svtplay_dl/service/tv4play.py,0,3,76,59,135
spaam/svtplay-dl,9d27fe86d162c92ca55cceafbe0678ee1f1f638c,lib/svtplay_dl/service/tv4play.py,1,5,69,52,121
frappe/frappe,4f304cfc6aa450090f2b9b477e1da73b79640d0a,frappe/model/document.py,0,0,0,0,0
frappe/frappe,d3f768fef9b96c91a7a04e2454ca6d94c1236635,frappe/model/document.py,0,0,0,0,0
frappe/frappe,b397ec3858a570e49d3ec424932ab8271c708af8,frappe/model/document.py,0,0,0,0,0
frappe/frappe,6c8a08d955b0769cce1084019cd9d6d1129a1fac,frappe/model/document.py,0,0,0,0,0
frappe/frappe,f66b23b96d4b2a52179c95771f02f3e04c6e2565,frappe/model/document.py,0,0,0,0,0
kizniche/Mycodo,8116f18c87fb09d11c1127869d79cbc2fa1c89f0,mycodo/utils/pid_controller_default.py,0,1,19,13,32
ray-project/ray,ee41800c16b78282ed75a89f3b879ed8d2fc7481,rllib/execution/rollout_ops.py,0,3,132,1,133
googleapis/python-aiplatform,e21762b703e3f6f45a40e42395b3387eee72141d,google/cloud/aiplatform_v1/services/prediction_service/client.py,0,4,4,3,7
geodynamics/burnman,f721b43e529d3743335783a23a9ea0dddded2894,burnman/tools/chemistry.py,0,1,604,4,608
Neutree/COMTool,352662a370b50ab4b0e7f159a395045f1fa01d68,COMTool/plugins/base.py,0,1,57,5,62
xupingmao/xnote,8f5c23d6aa15f2c8bbad1a04929f44f12534b869,xutils/cacheutil.py,0,0,0,0,0
googleapis/python-aiplatform,e21762b703e3f6f45a40e42395b3387eee72141d,google/cloud/aiplatform_v1/services/dataset_service/client.py,0,4,4,3,7
python-poetry/poetry-core,0904607b405185a37acb34e77f6d2fe597927e8e,src/poetry/core/_vendor/lark/parser_frontends.py,29,2,182,194,376
timcera/tsgettoolbox,750cb15418f276eb831d4d4517515ee94191802c,src/tsgettoolbox/ulmo/lcra/hydromet/core.py,0,1,1,3,4
bundlewrap/bundlewrap,e11af341069e5a822d855f9ff808ef288e624b99,bundlewrap/metadata.py,1,2,29,12,41
NeuralEnsemble/python-neo,cb5b7a85259ab35f1ecde720089b273ed96cdc09,neo/rawio/spikeglxrawio.py,1,3,95,104,199
NeuralEnsemble/python-neo,0970fb96203f0cbe82361f0c064ca33352659b65,neo/rawio/spikeglxrawio.py,0,5,20,33,53
python-attrs/cattrs,fe21a1dd70871c038322ecb689a43bcdda42975d,src/cattr/converters.py,0,1,799,2,801
wagtail/wagtail,ec70921e52b21c0ab463d1f243a2fc9c64c4e573,wagtail/snippets/views/snippets.py,19,2,93,150,243
HTTPArchive/beta.httparchive.org,f6f071da693d9092e48f3df3e30bc8624392a5cf,main.py,0,2,380,3,383
googleapis/storage-testbench,a81509a78df8a1d457e1eaf7764249a89f8f727b,gcs/object.py,2,7,10,40,50
google/skia,2e1cc9a946e1d4db68560c7f5488c00750f418b2,infra/bots/recipe_modules/checkout/api.py,0,3,15,2,17
envoyproxy/envoy,6247cec4cc5ec2e6385897ca3b2cbb853b481441,tools/proto_format/proto_sync.py,0,3,345,16,361
radiasoft/sirepo,adf86aff27c02aa5576d6a0f34f17dffffc49a72,sirepo/template/flash.py,0,8,1316,110,1426
radiasoft/sirepo,7a4348ba2f6e6b7fb8bc69214f36d9ee8d387f8d,sirepo/template/flash.py,8,11,149,222,371
dit/dit,6a360589ecc84840ffb2c9687a9202ea75e4191d,dit/algorithms/convex_maximization.py,0,2,113,41,154
mne-tools/mne-python,e2150ede1cfbdb44ad64268623a3d55ed87a1702,mne/beamformer/_lcmv.py,1,14,22,21,43
Nitrate/Nitrate,bc60f5327b1d061f7589cfb7b8da3f62a4c2337c,src/tcms/core/utils.py,0,2,45,23,68
arviz-devs/arviz,422c00b3cc24f3983bea283396bff0195374dcc3,arviz/plots/kdeplot.py,0,5,96,58,154
arviz-devs/arviz,b2b9cbc459c1ae9cafff4f3561f8481343a67c8d,arviz/plots/kdeplot.py,0,1,8,2,10
pyro-ppl/numpyro,5d9e033297532ae1a81a3e762ce7250aed5ab269,numpyro/util.py,1,2,23,32,55
isard-vdi/isard,b65eeb267bdb129ff49687016e6eb7b9c01d0d51,api/src/api/libv2/isardViewer.py,2,11,13,79,92
mupif/mupif,0b2db818d2eb0a520b8ccb6d9b265f40f00f21c0,mupif/pyroutil.py,0,14,78,24,102
pcolmant/repanier,5dc8882764d50b8f7d3650d848cb746a54297942,repanier/views/order_init_ajax.py,0,0,0,0,0
pcolmant/repanier,127d5ecd3f6620309cbae5c7f34669c265c19ab3,repanier/views/order_init_ajax.py,1,3,61,77,138
pcolmant/repanier,f4062cd6710c04d8ef9f577a278d1f29b7cadc36,repanier/views/order_init_ajax.py,0,1,5,4,9
deepmind/dm_control,662a3ce7befdc5f3bb17186ca5f9a9d8aa4f522a,dm_control/autowrap/binding_generator.py,0,7,280,0,280
openego/eDisGo,c2282e94a59258554a49ca0bc770f1c25092acc3,edisgo/io/ding0_import.py,0,2,101,1,102
openego/eDisGo,3e5db1b4db4a56e6bd7f8289a833d36e1c1ecda2,edisgo/io/ding0_import.py,0,1,4,7,11
dwavesystems/dimod,d186a4d27fa23df7eda48f822f2f16d12363b02a,dimod/sampleset.py,0,5,78,69,147
dwavesystems/dimod,9c042e321deba1521eb6a74a0e06a4248db2c34f,dimod/sampleset.py,5,5,87,158,245
googleapis/python-aiplatform,e21762b703e3f6f45a40e42395b3387eee72141d,google/cloud/aiplatform_v1/services/job_service/client.py,0,4,4,3,7
climu/openstudyroom,14032dd94dc2c0f23054228ee0f98511b8e67a7b,fullcalendar/views.py,0,3,29,27,56
climu/openstudyroom,d03d0cc602b5c6b3be4df8d71594ac5623e1383c,fullcalendar/views.py,2,10,406,5,411
adbar/htmldate,951c23d29459023b44ef1154811c20537552a2cc,htmldate/utils.py,1,5,74,79,153
wingtk/gvsbuild,f75d10d8ce99214e8fa1903e9b6d02eb82546b22,gvsbuild/utils/simple_ui.py,1,3,48,48,96
timcera/tsgettoolbox,e2a9bf94c110ad822d6f7fe239df3283a0b476fe,src/tsgettoolbox/functions/nwis.py,0,8,87,33,120
googleapis/python-aiplatform,4ddc426a6b4b8cd319fa885e363c94b35ef777d9,google/cloud/aiplatform_v1beta1/services/endpoint_service/client.py,0,15,271,100,371
googleapis/python-aiplatform,e21762b703e3f6f45a40e42395b3387eee72141d,google/cloud/aiplatform_v1beta1/services/endpoint_service/client.py,0,4,4,3,7
arviz-devs/arviz,b2b9cbc459c1ae9cafff4f3561f8481343a67c8d,arviz/stats/density_utils.py,0,2,5,3,8
JohnCremona/bianchi-progs,9f779d5ffa69b027d1e14fb53d3c067860125008,FD/alphas.py,0,2,138,504,642
minio/howto,941eab5e4d0883406afd43b075c45518bd2bf57c,sphinxext/minio.py,0,3,62,13,75
minio/howto,74e55a6dedd0089d5790c9691ba93327c4ddeae0,sphinxext/minio.py,1,9,69,36,105
pymedusa/Medusa,a1fa3e90d768201af8b5589005b5caf81273dabc,medusa/issue_submitter.py,0,4,10,3,13
googleapis/python-aiplatform,e21762b703e3f6f45a40e42395b3387eee72141d,google/cloud/aiplatform_v1beta1/services/metadata_service/client.py,0,4,4,3,7
oppia/oppia,f5052a3bea8bf14e868b29fc314fe4beedc1da56,core/controllers/topics_and_skills_dashboard.py,2,3,35,52,87
demisto/content,a048b5cace0be25baed01c454d494a405bbab2c3,Packs/CommonScripts/Scripts/ReadPDFFileV2/ReadPDFFileV2.py,7,10,28,196,224
isard-vdi/isard,d0ea9310fd387e1714be57ad992c487f87e320ba,api/src/api/views/DesktopsNonPersistentView.py,0,2,345,2,347
timcera/tsgettoolbox,e2a9bf94c110ad822d6f7fe239df3283a0b476fe,src/tsgettoolbox/functions/modis.py,0,7,264,2240,2504
wellenvogel/avnav,e6b030312aeebb980f57bab38f385b898ccefcbd,server/handler/layouthandler.py,17,1,160,153,313
psychopy/psychopy,0c38922448c0b58808e56997de6fe44668abd1a5,psychopy/tools/monitorunittools.py,0,0,0,0,0
psychopy/psychopy,efff1db1f7d43bdc5d872dc2752298f863ac84d2,psychopy/tools/monitorunittools.py,0,0,0,0,0
sfepy/sfepy,2a4d9961b29f3e73a1e0b1c130083acf5bb01a4e,sfepy/linalg/utils.py,0,2,83,14,97
inspirehep/inspire-next,edb3a3f461b0f533472ccad3656890a139eca859,inspirehep/modules/workflows/tasks/submission.py,0,2,5,0,5
googleapis/python-aiplatform,4ddc426a6b4b8cd319fa885e363c94b35ef777d9,google/cloud/aiplatform_v1beta1/services/pipeline_service/client.py,0,14,236,74,310
googleapis/python-aiplatform,e21762b703e3f6f45a40e42395b3387eee72141d,google/cloud/aiplatform_v1beta1/services/pipeline_service/client.py,0,4,4,3,7
moodpulse/l2,4324e71f86f669d89fd973004c4c02c3a825e348,researches/views.py,0,1,96,0,96
JamesPHoughton/pysd,d281fddb84fd5f18d4f7754aa44791a9806577bc,pysd/py_backend/statefuls.py,0,13,60,30,90
JamesPHoughton/pysd,e9cbc77e6ac92bef9ce77bb9034d78dda681c31d,pysd/py_backend/statefuls.py,0,2,1696,3,1699
frappe/erpnext,c3219ebad1cac35afc04cc051c9e215c70cd1e9b,erpnext/accounts/report/sales_register/sales_register.py,0,2,25,15,40
frappe/erpnext,1094319e3e8567e1c4db15e180d79778846a1a03,erpnext/accounts/report/sales_register/sales_register.py,1,14,25,82,107
frappe/erpnext,1d7dbd3456ed85f8f0c7052d08ad71761cd92890,erpnext/accounts/report/sales_register/sales_register.py,0,2,2,2,4
sqall01/alertR,99284bf65de50db3f628b3835c219cda90b2bd47,sensorClientFIFO/lib/sensor/fifo.py,0,8,156,12,168
ToFuProject/tofu,caf3f4347aec41a493de065e25d3ac472472d7d8,tofu/imas2tofu/_comp_mesh.py,0,1,96,96,192
gkunter/coquery,e86d4299e2d0b688e1f9cb2d3b0dfe9c13eb1f07,coquery/gui/contextviewer.py,1,8,49,42,91
xcat2/confluent,5ee0572f54262482d02e323fc100c5667ced483e,confluent_server/confluent/certutil.py,4,4,32,111,143
CenterForOpenScience/osf.io,a30cf0fa03d5a7e03142cb26a3d96663e16e1546,api/base/middleware.py,0,3,271,0,271
FRBs/FRB,6fe3eb97a5215767ad861f262b987fe628b8edf3,frb/builds/build_frbs.py,0,0,0,0,0
qtile/qtile,2ed6be192e05f4b8703ca22d66342df325217fc9,libqtile/widget/mpris2widget.py,12,5,86,196,282
jclgoodwin/bustimes.org.uk,5add772c7b9f32a19587fa26ff748ffd58921812,vehicles/management/commands/import_polar.py,0,0,0,0,0
jclgoodwin/bustimes.org.uk,f9800fa192569564d7dd1de576ac12027cac9b91,vehicles/management/commands/import_polar.py,0,0,0,0,0
bl4de/security-tools,b1f93635e5f74306795e856e580bf0a0e750194f,pef/pef.py,0,6,174,17,191
pallets/flask,92acd05d9bd33419ab885e4472b28a1d5cc15d2e,src/flask/helpers.py,0,2,37,1,38
pallets/flask,dcd1a1e0b67cefc5e41d363dad5f57ef9668e965,src/flask/helpers.py,2,2,141,94,235
HaroldMills/Vesper,ac8df90b18c1cc6c555be22039a1cffe4541c518,vesper/command/detect_command.py,0,14,69,14,83
ligo-cbc/pycbc,2ea2926067be24ae4fca20726a8c8ac8531a4d5e,pycbc/mchirp_area.py,2,10,190,112,302
lutris/lutris,ab4a62ab2b5713ee204db9d8e18ea0dd1d93da8a,lutris/game.py,0,13,83,46,129
lutris/lutris,b8701860288cf9ddf9f6512d9f85f9e427173a4f,lutris/game.py,0,2,15,18,33
lutris/lutris,d32b45c7c125d2dafee066f76fc394bddfe48710,lutris/game.py,0,3,14,33,47
lutris/lutris,79d78a291ef912795f3841f35d6d8c45bb74587c,lutris/game.py,0,1,3,0,3
pandas-dev/pandas,9b0ef5d07fb218df4e36e133d69b1ea4c6be43bd,pandas/core/indexes/datetimes.py,1,3,43,34,77
pandas-dev/pandas,bbffcb95cf8a9ecc190ed8f467c7e283bc7d50b8,pandas/core/indexes/datetimes.py,0,1,35,37,72
pandas-dev/pandas,9a00692ca757a6380b99fd544d25b8d95ab16241,pandas/core/indexes/datetimes.py,0,6,27,19,46
isard-vdi/isard,728eedd0e9497dcc23f0171d9ecbc5ef2d9e97fa,api/src/api/libv2/api_users.py,0,1,106,0,106
ray-project/ray,b3c93b91b09664f9da3210894f16f06365c3ef49,python/ray/serve/config.py,0,2,75,28,103
ray-project/ray,325fa2d614523b631a71070cb2d6c0b94548d349,python/ray/serve/config.py,2,4,627,61,688
psychopy/psychopy,97daa7ece0dd5c0085510cf33a110ef26ae579f6,psychopy/monitors/getLumSeries.py,0,0,0,0,0
scikit-learn/scikit-learn,3c75d36c6585b175f29f207c20cced1222b4d1b7,sklearn/linear_model/_glm/glm.py,0,10,53,33,86
acq4/acq4,c77636a76d68ffa1bc7dbd41edc522e523b909b8,acq4/modules/DataManager/FileInfoView.py,24,5,70,125,195
pantsbuild/pants,2c629bda26452483bb02457741506f779344750a,src/python/pants/help/help_printer.py,5,8,48,129,177
jeremiah-c-leary/vhdl-style-guide,a0709483e0af5dfe36d592b1c4f78a423428c228,vsg/rules/block_comment/rule_003.py,3,2,85,29,114
CanalTP/navitia,4106bd35d2c8bd8cf66dff5427d2c7349dc8f45c,source/jormungandr/jormungandr/scenarios/helper_classes/fallback_durations.py,8,6,84,141,225
PMEAL/OpenPNM,51cc256ddda61f9ce145b44df331e18a77e4172d,openpnm/algorithms/_invasion_percolation.py,0,6,225,103,328
bazelbuild/bazel,52bca194c61d6c60402c4af19b64d1d65ecf4ca8,tools/build_defs/pkg/archive.py,0,1,82,0,82
HumanCompatibleAI/imitation,5c9ba6da30019fc209f8b42259bdbe0f4fd32b3f,src/imitation/algorithms/bc.py,17,7,231,282,513
fabioz/PyDev.Debugger,51f4ae23c75dfac83d8d22a6a197a94f126a92d2,_pydevd_bundle/pydevd_safe_repr.py,0,3,50,2,52
gridsync/gridsync,e98237cf9e59e64668629df0d0da600848d74df6,gridsync/monitor.py,0,5,20,19,39
gridsync/gridsync,875c157018d1d8c73557b0ca921b5743b4d31ded,gridsync/monitor.py,0,3,28,25,53
gridsync/gridsync,9e1c987b89fb3e36341d0e7a85d0bedf8c6c9fd7,gridsync/monitor.py,0,7,233,1,234
gridsync/gridsync,289f9bdb7a161e4494a0c904648ff908ec82900e,gridsync/monitor.py,0,3,3,3,6
gridsync/gridsync,d539efecd6c615d4a49ec9341316a6697107b46f,gridsync/monitor.py,0,1,1,1,2
gridsync/gridsync,290f8263c40b52c8a79ee152e16c87e7f5983a9c,gridsync/monitor.py,0,1,35,14,49
gridsync/gridsync,e1a81a5e9a13a3bab43e7a2cf9725a9613974847,gridsync/monitor.py,2,2,32,39,71
tensorflow/tensorflow,5f97262ae6f36000e141b01b33c55f8eb1ee94a1,tensorflow/python/eager/backprop.py,0,6,283,97,380
tensorflow/tensorflow,958423c72b5ff292173ea06866ba0fd9993684d9,tensorflow/python/eager/backprop.py,0,10,34,0,34
tensorflow/tensorflow,44b255553c556c46bbae31a4019201843a82de7d,tensorflow/python/eager/backprop.py,1,8,16,30,46
all-of-us/raw-data-repository,37408c40b501a493df7553768bd143f458c310e2,rdr_service/services/consent/validation.py,0,3,42,17,59
lablup/backend.ai-manager,00fbe414333793e2107441086f639070654e2111,src/ai/backend/manager/container_registry/base.py,0,5,95,151,246
ewerybody/a2,b75e67177f19bbee3004a22968b237e3c8017190,ui/a2modsource.py,4,6,71,98,169
ewerybody/a2,f12c218b51953037b037ff439a091022a64ffdba,ui/a2modsource.py,2,7,63,45,108
googleapis/python-datastore,fab2f42d1dd3383253fde5cc55ca35b747de7bb8,google/cloud/datastore_v1/services/datastore/client.py,0,1,1,0,1
psy0rz/zfs_autobackup,14d45667deadd116e7f3f29ecd09bf6d4d3d4599,zfs_autobackup/ZfsAuto.py,0,3,19,9,28
psy0rz/zfs_autobackup,f0d00aa4e8a1abc96970e80a6c21f0b0f2b4ac80,zfs_autobackup/ZfsAuto.py,0,4,66,7,73
rackerlabs/django-DefectDojo,660d313110b9a58149079673687ebbcf9639b083,dojo/tools/scout_suite/parser.py,2,1,75,87,162
mne-tools/mne-python,62143cbeb12a822e08833941c4e0f1d450d35240,mne/parallel.py,1,7,76,55,131
ElementsProject/elements,634f6ec4eb9997d7bd0f8209fad49a4171d42384,contrib/devtools/security-check.py,0,5,111,59,170
mlflow/mlflow,de6603824e1ac7d9cdf925acb0f9fff073991332,mlflow/utils/search_utils.py,5,5,26,52,78
mlflow/mlflow,7ea4ce546c217bbf14b38eae3c676966d89b41cb,mlflow/utils/search_utils.py,8,5,14,109,123
ray-project/ray,4f86b5b5234a941d9572441a9637c3b959c629a1,python/ray/autoscaler/_private/monitor.py,0,5,61,16,77
scikit-learn/scikit-learn,8881bbffb92d4f428aef12bd025815df9d4a9e5e,sklearn/cross_decomposition/_pls.py,0,11,34,48,82
jeremiah-c-leary/vhdl-style-guide,a0709483e0af5dfe36d592b1c4f78a423428c228,vsg/rules/block_comment/rule_002.py,3,2,51,24,75
mariolukas/FabScanPi-Server,70657d08ff2a60badf2b99ec0475ce7cef54a278,src/fabscan/scanner/laserscanner/FSCalibrationActor.py,2,9,23,32,55
qutebrowser/qutebrowser,a20bb67a878b2e68abf8268c1b0a27f018d01352,qutebrowser/mainwindow/tabwidget.py,3,15,32,48,80
ray-project/ray,7f1bacc7dc9caf6d0ec042e39499bbf1d9a7d065,python/ray/util/dask/scheduler.py,0,10,39,38,77
SimpleITK/SimpleITK,9e472d57e043a782ba33ee838373c96a736c9a1a,Examples/FilterProgressReporting/FilterProgressReporting.py,0,2,2,5,7
huggingface/transformers,dcd3046f98431168831262419b082cd6f9821068,src/transformers/models/openai/modeling_tf_openai.py,0,12,20,17,37
huggingface/transformers,d02bd4f33351c8fe80bcd603dd5c491759f67f65,src/transformers/models/openai/modeling_tf_openai.py,0,18,157,72,229
Parallel-in-Time/pySDC,9dd2e44e7291fdad9ba3503e514e41ef539de8f0,pySDC/implementations/controller_classes/controller_MPI.py,8,1,377,377,754
SimpleITK/SimpleITK,9e472d57e043a782ba33ee838373c96a736c9a1a,Examples/Python/ConnectedThresholdImageFilter.py,0,4,4,5,9
uclapi/uclapi,1f30f8e521dcb318a871b8e77ebf8221915bf833,backend/uclapi/workspaces/management/commands/feed_occupeye_cache.py,0,1,45,3,48
diofant/diofant,279c0d44d7ceb0fe32f19268ff6f3574df7d8839,diofant/core/power.py,0,1,1,1,2
sequana/sequana,7ca7b78b59aa1f4f173c2501780e3f973d13d16b,sequana/modules_report/kegg_enrichment.py,3,6,147,59,206
GPflow/GPflow,174939cc3ed4ccbc7a3a0c6ff2c76775775178ed,gpflow/kullback_leiblers.py,0,5,14,14,28
astropy/astropy,39e1efe51ac81f1bf90fcce58e91184735b64286,astropy/cosmology/core.py,0,5,16,14,30
astropy/astropy,4b9287f336cc473554808651cfd584869ae9714b,astropy/cosmology/core.py,0,4,61,35,96
astropy/astropy,ba029b7d61c3276f3a5c720c2de9d85a24ff3eac,astropy/cosmology/core.py,17,30,49,403,452
astropy/astropy,682550e007fe3b5da8e20218c214cdb79fd2aecd,astropy/cosmology/core.py,0,6,3211,13,3224
astropy/astropy,0a811b178ee0248be05b226841ebaae478b5e7bf,astropy/cosmology/core.py,0,2,6,12,18
astropy/astropy,17995ef42d161c36a212b7be0998671df739e185,astropy/cosmology/core.py,0,2,6,12,18
olivierfriard/BORIS,2b8e60a198f48ecc79f7349c51d09b50147825c2,boris/plot_spectrogram_rt.py,0,6,16,22,38
olivierfriard/BORIS,aca350dca3b57553cc5b880fde3733cf0bd5d6aa,boris/plot_spectrogram_rt.py,0,10,21,29,50
Alexey-T/CudaText,9eed9bdea80797b5a1739ee11a48e213e8debf22,app/cudatext.app/Contents/Resources/py/sys/requests/auth.py,0,14,73,83,156
dnanexus/dx-toolkit,3979136b6ad7b9fe7242f50d0c49fe3bc849b59d,src/python/dxpy/cli/parsers.py,0,1,1,1,2
ray-project/ray,7f1bacc7dc9caf6d0ec042e39499bbf1d9a7d065,rllib/evaluation/worker_set.py,0,23,134,161,295
ray-project/ray,a322ac463c9c04f3ce99d943f7c84590ac4cd1f4,rllib/evaluation/worker_set.py,0,2,50,0,50
psi4/psi4,821134f62396ba27f9bcb8fbfa93ea2c370b7616,psi4/driver/driver_cbs.py,14,22,473,756,1229
zynthian/zynthian-ui,fdf529e73da2ac0a6861fc9ada6c7cdfb6836148,zyngine/zynthian_engine_jalv.py,1,2,12,13,25
zynthian/zynthian-ui,5a71c29f711e061273e3c8a69c2c356593f9abc1,zyngine/zynthian_engine_jalv.py,0,1,896,935,1831
frappe/erpnext,52189cba861e0d88cf9847f53bd5c125f683f824,erpnext/accounts/report/budget_variance_report/budget_variance_report.py,0,1,157,307,464
frappe/erpnext,494bd9ef78313436f0424b918f200dab8fc7c20b,erpnext/accounts/report/budget_variance_report/budget_variance_report.py,0,16,74,77,151
edgedb/edgedb,25edd1dd5d4ac2dab80f06e1b6f8f47e167a3b90,edb/server/compiler_pool/worker.py,1,3,201,25,226
ECP-CANDLE/Benchmarks,8cc5e04b8a54060de8a707f9a6dd25f1ddd10db5,Pilot1/Attn/attn_baseline_keras2.py,0,13,143,259,402
ccxt/ccxt,f9f8f1960128830b36281acb0f2005c2f364c70b,python/ccxt/async_support/luno.py,0,2,19,42,61
Erotemic/ubelt,044dae377eb4818077f0bee6b03922c47d38483b,ubelt/util_zip.py,0,3,10,2,12
SimpleITK/SimpleITK,9e472d57e043a782ba33ee838373c96a736c9a1a,Examples/Python/ExtractSlice.py,0,1,1,1,2
pedohorse/hpaste,45bdc0795686b3d254b01c1d9a17786a54a87d99,python3.7libs/hpaste/hpasteshelffunctions.py,2,3,4,23,27
Parsl/parsl,e338b85957d249446c9a303367cbfc7e99f45ae1,parsl/executors/status_handling.py,0,2,3,3,6
matrix-org/synapse,800ba87cc881856adae19ec40485578356398639,synapse/handlers/device.py,0,1,1,1,2
Samsung/TizenRT,34abcb614c4e0461c3d8ceea989c28bd94a187fb,os/tools/mksamsungheader.py,0,2,10,2,12
lutris/lutris,da61ff508c22c4626412201722a7da08a6a4aabc,lutris/gui/lutriswindow.py,0,10,62,48,110
lutris/lutris,01e25e47677135b1ecc8ff6b3c71161bd93f9d77,lutris/gui/lutriswindow.py,0,5,172,19,191
lutris/lutris,00bbe32b0934025090898843fcb50aa1a5b52f64,lutris/gui/lutriswindow.py,0,2,13,8,21
lutris/lutris,0e601a6e31880ee40864aa2248372ce5c8cf2208,lutris/gui/lutriswindow.py,8,27,64,128,192
lutris/lutris,7224318592266dd305c62b3d785e726358cba186,lutris/gui/lutriswindow.py,5,8,64,36,100
lutris/lutris,09996f092120799a38d51a72d4e0aef7a72faab6,lutris/gui/lutriswindow.py,0,1,11,1,12
lutris/lutris,3757415a7073b67444bb0689f0521dc927429dad,lutris/gui/lutriswindow.py,0,18,126,98,224
lutris/lutris,992f4e27bc3554971c172407e25c8018d9a1d3cb,lutris/gui/lutriswindow.py,0,16,146,6,152
lutris/lutris,370775cb37b7b374346cb1a69b9a79f262ef20f4,lutris/gui/lutriswindow.py,2,4,12,11,23
lutris/lutris,764c40e11b9ac99440b260e978318dfad0194aa8,lutris/gui/lutriswindow.py,0,3,16,0,16
lutris/lutris,4ae90fd535eda10ba94fdd1ea869f21eefadf20d,lutris/gui/lutriswindow.py,0,3,16,0,16
lutris/lutris,8a597efba27900d8d8fd633c0557dd2d56f8835c,lutris/gui/lutriswindow.py,4,3,12,26,38
Nic30/hwtHls,a50839b8cc600c01cfc6aeae7fe62bee91cff1d9,hwtHls/netlist/translation/toTimeline.py,1,8,81,115,196
frappe/erpnext,494bd9ef78313436f0424b918f200dab8fc7c20b,erpnext/selling/report/available_stock_for_packing_items/available_stock_for_packing_items.py,0,2,8,26,34
scikit-learn/scikit-learn,82df48934eba1df9a1ed3be98aaace8eada59e6e,sklearn/neighbors/_nearest_centroid.py,0,6,22,26,48
scikit-learn/scikit-learn,a601e8c74ebf5c7220a32f52e82fa08532215d12,sklearn/neighbors/_nearest_centroid.py,0,5,5,16,21
scikit-learn/scikit-learn,4c89b3b4f69fc8abf4715b96137aa022674c80e4,sklearn/neighbors/_nearest_centroid.py,0,7,58,13,71
magfest/ubersystem,7ad7e8d4d2d81efe5a992b1722b24e3acc6a0d59,uber/api.py,10,13,89,353,442
StellarCN/py-stellar-base,f4506f9d87ad4c614079720fa49718292d36fe96,stellar_sdk/xdr/set_options_op.py,0,2,19,1,20
gitpython-developers/GitPython,78b99d35f04dc96596a751376656f1df1fba09c1,git/cmd.py,0,6,14,28,42
gitpython-developers/GitPython,21ec529987d10e0010badd37f8da3274167d436f,git/cmd.py,0,49,224,368,592
coreboot/chrome-ec,7540e7b47b55447475bb8191fb3520dd67cf7998,chip/mchp/util/pack_ec_mec152x.py,0,15,503,629,1132
frappe/erpnext,2620bf402ff06bfca3788a21230037dd2209e645,erpnext/stock/stock_ledger.py,1,1,19,18,37
frappe/erpnext,4b29fb6d08a28f0b399d9e56c25a867b4035d5db,erpnext/stock/stock_ledger.py,1,4,78,20,98
frappe/erpnext,494bd9ef78313436f0424b918f200dab8fc7c20b,erpnext/stock/stock_ledger.py,0,48,294,551,845
rdkit/rdkit,5a6e3c9e555cd1322833b786769b492f0f12b553,rdkit/Chem/Pharm3D/EmbedLib.py,0,38,186,179,365
rapydo/do,19801b2bd3c4d46c4ac05e14d48e6c462588ff0e,controller/commands/install.py,0,4,148,10,158
cloudtools/troposphere,6a998b7fd7c404a80d46e9f3d796fd71c3e378fd,troposphere/eks.py,3,6,83,129,212
frappe/erpnext,494bd9ef78313436f0424b918f200dab8fc7c20b,erpnext/support/report/support_hour_distribution/support_hour_distribution.py,0,2,43,53,96
riga/law,5dc74babe6cd793922658aa6a7bc338ac13b8c40,law/contrib/htcondor/workflow.py,0,3,17,9,26
riga/law,c709f4c5892ad8bdb8de18c6c740b5ce18959e69,law/contrib/htcondor/workflow.py,0,3,11,10,21
riga/law,39cc5a7f35888009d1032a10da1b1ca181046069,law/contrib/htcondor/workflow.py,0,2,51,136,187
scikit-learn/scikit-learn,e5429cb7f1ab6086c575d367477b072aabcddc83,sklearn/ensemble/_iforest.py,0,14,22,37,59
scikit-learn/scikit-learn,7c95b392aa48f396e02adc2f7052455166feb189,sklearn/ensemble/_iforest.py,0,6,21,28,49
homecon/homecon,0e30c27a21df728f8ef9c32a7bcf5995ab24da95,backend/src/homecon/core/states/dal_state_manager.py,2,4,18,18,36
candlepin/subscription-manager,1caad5540ddd7938232c360d0497f6d57b38c305,src/subscription_manager/repofile.py,0,2,3,3,6
candlepin/subscription-manager,835a6b80ee84237b0796ad464438e5b6e5ab0523,src/subscription_manager/repofile.py,0,12,17,17,34
RT-Thread/rt-thread,f3b72aa179a79e1028fcbd91c51899fd44c00723,tools/rt_studio.py,0,3,23,22,45
ccxt/ccxt,15f05546728b2fcaf7fbb29f9308629a2edadd9c,python/ccxt/async_support/novadax.py,0,3,35,58,93
bitcoin/bitcoin,061acf62a15ad3dbb9f055b7c2569b9832ed623a,contrib/devtools/security-check.py,0,3,23,10,33
bitcoin/bitcoin,983e0a20580b413880977862e3b291c5f422e241,contrib/devtools/security-check.py,0,4,12,4,16
mupif/mupif,0de7b32cb718109464081b33f0b896a7d9d116cc,mupif/heavydata.py,6,6,944,28,972
Ouranosinc/Magpie,85eb58732c827a8b909620ee9840a31766119491,magpie/app.py,0,2,30,3,33
Ouranosinc/Magpie,4d84224738f64b180dbce0a4c79cf07b8da0a93c,magpie/app.py,1,4,27,58,85
candlepin/subscription-manager,835a6b80ee84237b0796ad464438e5b6e5ab0523,src/rhsm/connection.py,0,42,151,259,410
SimpleITK/SimpleITK,9e472d57e043a782ba33ee838373c96a736c9a1a,Examples/ImageRegistrationMethodBSpline1/ImageRegistrationMethodBSpline1.py,0,5,12,20,32
spectralDNS/shenfun,4e36d736787c28adca45f61861e6d9ebeb219be8,shenfun/jacobi/bases.py,17,12,609,527,1136
OCA/geospatial,775d2a11d6bedde2e2d0b18fa59b64b8f013f3a0,base_geoengine/fields.py,0,8,41,59,100
SeleniumHQ/selenium,99fc0e0c8684ecd7e683093605aea09857529340,py/selenium/webdriver/support/color.py,0,0,0,0,0
SeleniumHQ/selenium,0e24f411f2271388f313be787d771445092b5a71,py/selenium/webdriver/support/color.py,0,0,0,0,0
SeleniumHQ/selenium,3824c3e9c5bb66b768e5ba2b56e8427e4f4f3c59,py/selenium/webdriver/support/color.py,0,1,1,1,2
Maselkov/GW2Bot,da0c4dc4213bade7f5f7c277ce718319f4a0901b,guildwars2/wvw.py,1,4,63,57,120
dedupeio/dedupe,392144a1430373c866de0fef445a777debff2cb6,dedupe/convenience.py,2,1,53,52,105
hasgeek/funnel,6997b117c9a09fdefa03c92117138c6a8c44751a,funnel/models/sync_ticket.py,0,4,11,13,24
rocky/python3-trepan,165213ca5c39e822379abb92b5c4f0df8769535b,trepan/processor/command/info_subcmd/files.py,0,3,39,44,83
SimpleITK/SimpleITK,9e472d57e043a782ba33ee838373c96a736c9a1a,Examples/N4BiasFieldCorrection/N4BiasFieldCorrection.py,0,3,12,21,33
SimpleITK/SimpleITK,9e472d57e043a782ba33ee838373c96a736c9a1a,Examples/DicomSeriesReader/DicomSeriesReader.py,0,1,1,1,2
buildbot/buildbot,679770715f6e643fb5b3da19fc724218b63e86dd,master/buildbot/www/hooks/base.py,0,1,1,1,2
NetworkManager/NetworkManager-ci,d1ff7ca0fe2e4e42bcfc8d11c7e8f8754fe99ae2,run/centos-ci/cico_gitlab_trigger.py,0,2,25,17,42
NetworkManager/NetworkManager-ci,9aa3d2fdad4c8b5058fc9fe1e9cede442c3bbc70,run/centos-ci/cico_gitlab_trigger.py,0,1,2,0,2
privacyidea/privacyidea,6d0757722d09694153a18d3320fd6e199bdfb710,privacyidea/lib/importotp.py,0,7,15,8,23
cobbler/cobbler,0b1a9e804fc9e2353096b485ac08656fbec3cc7b,cobbler/services.py,0,7,7,17,24
MozillaSecurity/FuzzManager,bb12ebd389864bbba8c2c9e15ab808efae54e660,FTB/Signatures/CrashInfo.py,0,79,234,394,628
espressif/esp-idf,069b82401cf472185b521e3af0e3beecfdf572d7,tools/esp_prov/transport/ble_cli.py,7,6,282,72,354
coreboot/chrome-ec,7540e7b47b55447475bb8191fb3520dd67cf7998,extra/usb_power/powerlog.py,0,2,829,933,1762
dpressel/baseline,746fcf5fc8ec939094fb4f50939e15eddd7428df,layers/eight_mile/tf/optz.py,31,12,554,20,574
eljost/pysisyphus,e3500c2066e104a5e9dff96b5d455386f13aed57,pysisyphus/cos/NEB.py,0,7,31,52,83
ligo-cbc/pycbc,0762ce4537cd34aa7851e0507f458ccdd8df62a6,pycbc/workflow/configuration.py,0,18,688,218,906
ligo-cbc/pycbc,defabdd88036668ed755c785275a4537dc0e0086,pycbc/workflow/configuration.py,0,2,173,10,183
StingraySoftware/stingray,34957b43ae27e888140a5e9042e527e336983cc8,stingray/powerspectrum.py,0,0,0,0,0
StingraySoftware/stingray,3adf0f4faef25a0a1656a2ef59b2b62da298b864,stingray/powerspectrum.py,2,13,63,95,158
frappe/erpnext,494bd9ef78313436f0424b918f200dab8fc7c20b,erpnext/stock/report/supplier_wise_sales_analytics/supplier_wise_sales_analytics.py,0,3,26,61,87
SimpleITK/SimpleITK,9e472d57e043a782ba33ee838373c96a736c9a1a,Examples/Python/ReadAndShow.py,0,1,1,1,2
sqall01/alertR,2535ae18cfdfc1d6f4597989e7cc968c065a96c1,sensorClientPing/lib/sensor/ping.py,0,4,57,7,64
hydroshare/hydroshare,5cedfc5d0d433eb1cca666c5c3faa1f62451d8ee,hs_file_types/forms.py,0,2,127,4,131
hydroshare/hydroshare,42f92737ee001179e16d02c6e53d3616de43fd37,hs_file_types/forms.py,0,1,126,3,129
vilemnovak/blendercam,b0a1d7f129858d972c119e16f8cc052d6bf5d8cd,scripts/addons/cam/strategy.py,0,5,7,12,19
vilemnovak/blendercam,13e5f4b217341086b422541ce1c8ccd5078c9561,scripts/addons/cam/strategy.py,0,24,64,54,118
cobbler/cobbler,a4a8771d6b37385f1cf9ebd449c0dff351e0fbfb,cobbler/remote.py,1,3,0,3,3
cobbler/cobbler,1cbf9ad6995db7a67197a34b9cb9067b64a8af0a,cobbler/remote.py,1,3,4,4,8
cobbler/cobbler,b47081b1f36e57a2a737a3cf841b1f38b31c15ef,cobbler/remote.py,1,1,0,3,3
cobbler/cobbler,0b1a9e804fc9e2353096b485ac08656fbec3cc7b,cobbler/remote.py,0,65,127,391,518
MozillaSecurity/FuzzManager,bb12ebd389864bbba8c2c9e15ab808efae54e660,server/crashmanager/management/commands/triage_new_crash.py,0,4,4,6,10
matrix-org/synapse,a7304adc7d383caad1b3f83fa707b1090323ecca,synapse/handlers/federation_event.py,1,2,52,72,124
matrix-org/synapse,800ba87cc881856adae19ec40485578356398639,synapse/handlers/federation_event.py,0,1,1,1,2
ECP-CANDLE/Benchmarks,3e1b15b7e71b0ab264b033bb011bd2db4cc1fc99,common/ckpt_keras_utils.py,0,1,1,1,2
ECP-CANDLE/Benchmarks,8cc5e04b8a54060de8a707f9a6dd25f1ddd10db5,common/ckpt_keras_utils.py,0,27,202,297,499
lowRISC/opentitan,ca7ed9cf6b733a425ab5333763e9a5fd518d89e8,util/dvsim/FlowCfg.py,0,8,42,35,77
openego/eDisGo,d6645e363f0eea22038706c075069c1011d07fc5,edisgo/edisgo.py,0,1,380,7,387
openego/eDisGo,c2f208c40b79f155c277fabae2c859d7893a34f2,edisgo/edisgo.py,0,1,392,69,461
openego/eDisGo,1d26b827441231f7cd96b0c06d0c53d7301acd0e,edisgo/edisgo.py,0,4,27,52,79
openego/eDisGo,3ca89082423ff281cf3318cd1ad28bbedd3f8df0,edisgo/edisgo.py,1,19,196,36,232
openego/eDisGo,b5b8c64e8f16b4c77664dec2ea967d46d3bf3142,edisgo/edisgo.py,0,3,3,3,6
StartupsPoleEmploi/labonneboite,dfa4852e6d1fd3de4345518b49b1bae1f3524343,labonneboite/scripts/create_index.py,2,7,34,85,119
StartupsPoleEmploi/labonneboite,100e7073178db699456098857280e0523a1dbec6,labonneboite/scripts/create_index.py,0,6,56,6,62
mitmproxy/mitmproxy,b3587b52b25077f68116b9852b041d33e7fc6601,mitmproxy/contentviews/grpc.py,0,31,120,179,299
cpn18/track-chart,ceaec27fb83306465e3a453ed37ac87810f78c4f,gps-pi/gps_logger.py,0,4,44,30,74
scikit-learn/scikit-learn,94d49b7bc6712a425c58916fa332343d0b8dd90a,sklearn/neighbors/_lof.py,0,3,6,14,20
frappe/erpnext,73ade04dcf8a4ab31fc803f12a430e417da6967a,erpnext/stock/dashboard_chart_source/warehouse_wise_stock_value/warehouse_wise_stock_value.py,0,1,14,11,25
openstack/neutron,b48595e419a02592dcf319ea4b4dda0912efa050,neutron/plugins/ml2/drivers/l2pop/db.py,3,7,7,11,18
geopandas/geopandas,a1263e56cbef57913c90e8ec7583c0853ad6ad7d,geopandas/io/file.py,7,15,41,202,243
demisto/content,26674363435d90df2fce6e2939be1da4c829324e,Packs/CTIX/Integrations/CTIX/CTIX.py,2,9,82,258,340
google/turbinia,ebd47efac054536e4fc9e67803dece913aa3f1fa,turbinia/workers/partitions.py,0,4,6,21,27
anselmobd/fo2,c34d40a7689e336752ea64c94893930c38268271,src/logistica/management/commands/sync_nf.py,0,1,2,9,11
awslabs/sockeye,50393fc452bf03acb1578abcc258f822992f3d39,sockeye/model.py,0,5,10,16,26
huggingface/transformers,97a375484c618496691982f62518130f294bb9a8,src/transformers/file_utils.py,0,5,71,9,80
huggingface/transformers,4975002df50c472cbb6f8ac3580e475f570606ab,src/transformers/file_utils.py,0,2,3035,125,3160
PseudoTV/PseudoTV_Live,492fb1c36d2e37d35770ec9bd68b6c38c083778c,plugin.video.pseudotv.live/resources/lib/service.py,0,0,0,0,0
PseudoTV/PseudoTV_Live,974a6ad0411b235383462b8161ec9e6659154277,plugin.video.pseudotv.live/resources/lib/service.py,6,11,315,180,495
frappe/erpnext,bdab0eea0ff5efcbc5b1d24a68ec16909c495152,erpnext/accounts/doctype/purchase_invoice/purchase_invoice.py,0,0,0,0,0
frappe/erpnext,39e2c2bb097a8c93efd7417c348d17ead63c9ad7,erpnext/accounts/doctype/purchase_invoice/purchase_invoice.py,1,2,2,5,7
frappe/erpnext,224737b9ed38b2423eb298771451e7e6704bc37e,erpnext/accounts/doctype/purchase_invoice/purchase_invoice.py,5,5,72,92,164
frappe/erpnext,1b30ca6a36e2f088439641ba5bbd370475defa85,erpnext/accounts/doctype/purchase_invoice/purchase_invoice.py,0,20,14,25,39
frappe/erpnext,be4fc1a78eff5b2d6616565cef6a3f0634f4bbde,erpnext/accounts/doctype/purchase_invoice/purchase_invoice.py,0,3,1,18,19
frappe/erpnext,494bd9ef78313436f0424b918f200dab8fc7c20b,erpnext/accounts/doctype/purchase_invoice/purchase_invoice.py,0,36,568,938,1506
frappe/erpnext,b60fad61136d8e85e055e9b3628cccce7302c7bd,erpnext/accounts/doctype/purchase_invoice/purchase_invoice.py,0,36,568,938,1506
kizniche/Mycodo,4e2856128998cf3c783863f61e81a35574254be7,mycodo/functions/display_generic_lcd_16x2_i2c.py,6,6,20,76,96
pypa/pip,6c3853a325b89fb356100bfe595ddd4a7214cdae,src/pip/_vendor/requests/auth.py,0,14,73,83,156
MozillaSecurity/FuzzManager,bb12ebd389864bbba8c2c9e15ab808efae54e660,misc/libfuzzer/libfuzzer.py,0,7,54,150,204
aerospike/aerospike-admin,0974a9f62d91691c1616de7ccc5c4bbbcc047ea7,lib/utils/util.py,1,22,27,75,102
aerospike/aerospike-admin,b45d056c1fe123542c8f01684462561889da8060,lib/utils/util.py,7,6,61,71,132
wagtail/wagtail,d967eccef28ce47f60d26be1c28f2d83a25f40b0,wagtail/contrib/settings/jinja2tags.py,6,3,25,26,51
PanDAWMS/panda-bigmon-core,cd81cd537820b3e18d964a658c9522cf4f5717e6,core/cachecontroller/schedinstances/PandaLogsStorageCleanUp.py,0,2,3,11,14
scikit-learn/scikit-learn,a23c2edf47698ee6702a6dccf9f83bc541819470,sklearn/decomposition/_dict_learning.py,9,21,78,543,621
scikit-learn/scikit-learn,1a53241cdc34e49b97973b2a257c5222ddbe7e81,sklearn/decomposition/_dict_learning.py,0,17,350,89,439
simpeg/discretize,d42f60302a8ff928e44094e3c4215c907fb9f824,discretize/base/base_mesh.py,0,0,0,0,0
espressif/esp-idf,cc75721f9c080e104d4af811b4ef997936b3d649,tools/mass_mfg/mfg_gen.py,5,7,251,220,471
espressif/esp-idf,bbc3add0e3285d3a50a596c2ff4c6c6b209fd5c9,tools/mass_mfg/mfg_gen.py,0,10,289,179,468
ray-project/ray,7f1bacc7dc9caf6d0ec042e39499bbf1d9a7d065,python/ray/_private/prometheus_exporter.py,0,17,68,47,115
frappe/erpnext,494bd9ef78313436f0424b918f200dab8fc7c20b,erpnext/stock/doctype/material_request/material_request.py,0,17,220,343,563
python-control/python-control,de4c75cdc938b65ee1af3a85051410f8643a559f,control/iosys.py,0,2,1,6,7
python-control/python-control,994fedc637304ca8f2379480feacc2ca483c68e6,control/iosys.py,0,2,1,2,3
python-control/python-control,4ef15c4e95ec73cf5fc4d571be103e67b00caadf,control/iosys.py,13,18,206,179,385
python-control/python-control,7f48535c1b035976a7eabf5dc7f6aea5ef02b88f,control/iosys.py,0,8,10,24,34
espressif/esp-idf,27ce4d13df3a4952d0cda25b1b5d775ba24f5cbe,components/espcoredump/espcoredump.py,23,31,176,731,907
espressif/esp-idf,bab38307974b19cbeb933c6eafdeec461724124b,components/espcoredump/espcoredump.py,0,1,2,2,4
frappe/erpnext,fc03a0463c0611c5ed48a878b5c042ce2348e4cd,erpnext/controllers/buying_controller.py,3,13,210,46,256
frappe/erpnext,50d8c4a10fa9cf11df36f339a9dcce9317c49bdf,erpnext/controllers/buying_controller.py,4,14,284,60,344
frappe/erpnext,0bef91c2419cfc2c3ab0b254851127461c2b180a,erpnext/controllers/buying_controller.py,0,1,0,1,1
frappe/erpnext,ae4ff5a4035f834c548b2a72d3fd3a25e23ef292,erpnext/controllers/buying_controller.py,2,15,298,43,341
frappe/erpnext,f4dc71661d1d07e883e83b5a27ba9b4b1bbce7cf,erpnext/controllers/buying_controller.py,3,16,312,55,367
frappe/erpnext,d2b9093ecce124fe165a3a6aa898483e80cc1890,erpnext/controllers/buying_controller.py,2,15,313,44,357
frappe/erpnext,a77b8c9fcc1ed7a2a44d2cdf3a3b50c5d8a4366f,erpnext/controllers/buying_controller.py,1,16,77,52,129
frappe/erpnext,494bd9ef78313436f0424b918f200dab8fc7c20b,erpnext/controllers/buying_controller.py,0,25,220,341,561
City-of-Helsinki/kerrokantasi,6ba29dc506f4048a1683b11832047d39ca025a16,democracy/models/files.py,0,1,4,2,6
espressif/esptool,513898db2ac7a1990dc94aa6f49cda3165c442bf,espsecure.py,0,1,1136,6,1142
frappe/frappe,c0c5b2ebdddbe8898ce2d5e5365f4931ff73b6bf,frappe/utils/doctor.py,0,0,0,0,0
stb-tester/stb-tester,2d9d0bda2d83353c700bb23cc1dae32b4aeb488e,_stbt/imgutils.py,2,3,18,29,47
RiiConnect24/File-Maker,5edef0dcf9ae6d53d58a4a14d52a85cbe5b49f74,Channels/Nintendo_Channel/ninfile2.py,0,26,39,46,85
pytorch/fairseq,806855bf660ea748ed7ffb42fe8dcc881ca3aca0,fairseq/models/transformer/transformer_decoder.py,0,1,3,0,3
SimpleITK/SimpleITK,9e472d57e043a782ba33ee838373c96a736c9a1a,Examples/ImageRegistrationMethod4/ImageRegistrationMethod4.py,0,4,6,14,20
edgedb/edgedb,f9aada9845b5cb65be3371a8262b206cddb84c4b,edb/edgeql/compiler/expr.py,0,1,21,10,31
angr/angr,44452ab53cff926d10b8ce6f3d28a2f65c647a28,angr/analyses/decompiler/utils.py,1,2,275,41,316
ray-project/ray,7f1bacc7dc9caf6d0ec042e39499bbf1d9a7d065,rllib/utils/exploration/per_worker_ornstein_uhlenbeck_noise.py,0,4,11,15,26
frappe/frappe,c0c5b2ebdddbe8898ce2d5e5365f4931ff73b6bf,frappe/email/doctype/notification/notification.py,0,0,0,0,0
openturns/otfmi,7abe3cefd204b0cbafb474719737fb54e12feff9,otfmi/function_exporter.py,0,4,97,145,242
openturns/otfmi,e7dff7f362362858dcb2131fcf289e4b3bb87dd6,otfmi/function_exporter.py,0,14,85,150,235
corpnewt/CorpBot.py,63bc266de4bada799f4581bba84f2d607c5d9703,Cogs/XpStack.py,0,4,38,4,42
deepmind/acme,d436d6be4744ca7ad00f039a4781a445fb84f3c4,acme/jax/losses/mpo.py,2,8,40,26,66
desihub/desispec,695017f702edba26d0d2e547cc1119c4dcd2a911,py/desispec/scripts/group_spectra.py,12,1,375,302,677
desihub/desispec,72d61f80ae4b3c145ba329cff7e08512e185a849,py/desispec/scripts/group_spectra.py,0,3,181,58,239
scalyr/scalyr-agent-2,123285e1b5acd5ae98052812d73236385fce8375,scalyr_agent/util.py,0,3,43,4,47
buildbot/buildbot,679770715f6e643fb5b3da19fc724218b63e86dd,master/buildbot/process/users/users.py,0,1,1,1,2
huggingface/transformers,f0aacc140bff272b12d234d598439e44074b67e4,src/transformers/models/marian/modeling_tf_marian.py,0,1,6,0,6
huggingface/transformers,050e0b44f6a63131b56d493543ab39fb7b4f20ca,src/transformers/models/marian/modeling_tf_marian.py,8,13,21,128,149
ligo-cbc/pycbc,59e0dabcff5bfd6ec78842444a7363bfce1504bd,pycbc/inference/models/relbin.py,7,11,108,152,260
pytransitions/transitions,56991324e0377bef2b3fce3241382fae5487add3,transitions/extensions/nesting.py,0,11,57,47,104
rocky/python-uncompyle6,5a83c7c643d6082d5829207864eca4969ee26a38,uncompyle6/scanners/scanner30.py,0,17,105,188,293
SimpleITK/SimpleITK,9e472d57e043a782ba33ee838373c96a736c9a1a,Examples/Python/CannyEdge.py,0,1,4,5,9
walles/px,f44fcb07910f8699a7cfa8e77035c4e278c76555,px/px_top.py,0,3,21,22,43
walles/px,ff26a5726467dbabff7a37af09c79f6dc7a76198,px/px_top.py,1,2,29,39,68
pcolmant/repanier,4826636e2de931c7f10bcb612c0e61ca218d2bec,repanier/models/invoice.py,0,26,261,485,746
pcolmant/repanier,a7ed925bdb77278fd20742e2eca735892d36fe55,repanier/models/invoice.py,6,24,706,532,1238
pcolmant/repanier,e2516fbf1496b3992f58336b043f841843179e9a,repanier/models/invoice.py,1,6,90,97,187
rdkit/rdkit,6e67e2bbde89c6470866fd068256c59e603e12ce,rdkit/Chem/Fingerprints/FingerprintMols.py,0,12,46,35,81
DemocracyClub/yournextrepresentative,7ec001cdc4ff0aece5cb50c54f4e6c36d863ee1a,ynr/apps/moderation_queue/views.py,0,1,13,1,14
colour-science/colour,eb1fcd4c3de5443ed48a7dddbaf85a3951ff23eb,colour/notation/munsell.py,0,27,39,119,158
matrix-org/synapse,488ffe6fdb36c7479052096489c683777597c2aa,synapse/handlers/federation.py,1,7,7,7,14
matrix-org/synapse,8dee601054089311b81efd6239b458401da063e3,synapse/handlers/federation.py,1,1,1,1,2
matrix-org/synapse,a215b698c43f4cfe8a2fdb9c160c8ecd1c1297c5,synapse/handlers/federation.py,0,4,7,12,19
matrix-org/synapse,be294d6fde1b8b37b9d557e56973deb92790ddb8,synapse/handlers/federation.py,2,4,6,95,101
matrix-org/synapse,03d3792f3c7978ecc057cab19ff95c8310403665,synapse/handlers/federation.py,0,46,102,112,214
matrix-org/synapse,800ba87cc881856adae19ec40485578356398639,synapse/handlers/federation.py,0,1,1,1,2
rdkit/rdkit,4f230e6ba2773c10ff4c7a758a57f426cae95afb,rdkit/Chem/Fraggle/FraggleSim.py,0,8,22,15,37
libAtoms/matscipy,c30924bdc8da5e9204ce82e715f4585ee76eb867,matscipy/calculators/pair_potential/calculator.py,0,1,3,2,5
libAtoms/matscipy,3d2db9d6f7377d68828d14f7de60a4bc3dfadcde,matscipy/calculators/pair_potential/calculator.py,1,4,46,28,74
libAtoms/matscipy,fd79725635b3188d100113ccec53573eacdd0387,matscipy/calculators/pair_potential/calculator.py,0,12,88,170,258
nortikin/sverchok,6019f8e84476e257bb24b026105fcf4d22ce0b4c,ui/sv_3d_panel.py,0,5,72,1,73
materialsproject/pymatgen-db,d214a5e52c0a3b5dc2bb2cd16548810e52a9ae48,pymatgen/db/util.py,0,0,0,0,0
materialsproject/pymatgen-db,ea4d831f9285b0d3f611549cffa4588809870e30,pymatgen/db/util.py,0,4,2,10,12
frappe/erpnext,494bd9ef78313436f0424b918f200dab8fc7c20b,erpnext/www/support/index.py,0,3,16,30,46
pandas-dev/pandas,cf2dfa76d2736af151e429843be986884e1e74e4,pandas/core/arrays/numeric.py,7,6,5,59,64
pandas-dev/pandas,901501375bd45242f3dc75bc1de593ffb5d8dfd1,pandas/core/arrays/numeric.py,0,1,3,1,4
czcorpus/kontext,330fa5e7581192b978deaca4d08ffea90d72cb25,lib/conclib/pyconc.py,0,6,84,24,108
candlepin/subscription-manager,835a6b80ee84237b0796ad464438e5b6e5ab0523,src/subscription_manager/cli_command/identity.py,0,2,11,24,35
Alexey-T/CudaText,9eed9bdea80797b5a1739ee11a48e213e8debf22,app/py/sys/requests/auth.py,0,14,73,83,156
couchbase/couchbase-python-client,6d305796b094024c2ea07c8c963899999420f610,acouchbase/cluster.py,24,1,339,247,586
ECP-CANDLE/Benchmarks,af726cad4c7faa1e8a36adf1240c45392c0b3cb2,Pilot1/Uno/uno_baseline_keras2.py,0,0,0,0,0
ECP-CANDLE/Benchmarks,a5acd69aa4769318ad6db4b1dd50fd6dd64dfc0c,Pilot1/Uno/uno_baseline_keras2.py,4,18,113,95,208
ECP-CANDLE/Benchmarks,8cc5e04b8a54060de8a707f9a6dd25f1ddd10db5,Pilot1/Uno/uno_baseline_keras2.py,0,15,167,338,505
akrherz/pyIEM,9037661435b5080f92ea723384af93492a26360f,src/pyiem/nws/products/vtec.py,0,2,99,5,104
akrherz/pyIEM,4680034660c36e464ad8fe7a839c196b3311cc37,src/pyiem/nws/products/vtec.py,0,5,283,6,289
DIRACGrid/WebAppDIRAC,fb7ab0a4770e0092cae70597f403c568447107dc,src/WebAppDIRAC/WebApp/handler/RegistryManagerHandler.py,0,15,36,19,55
corradio/electricitymap,1143a37ff1509627297744a8e74aff2793b22246,parsers/ajenti.py,0,2,70,101,171
rhinstaller/anaconda,037d792e7bfef64a4bbe2f91731d5092a265509b,pyanaconda/payload/dnf/payload.py,1,6,54,20,74
rhinstaller/anaconda,dcb386d36e2ecc5ca0919c522f469135e263d642,pyanaconda/payload/dnf/payload.py,2,2,44,54,98
CenterForOpenScience/osf.io,b9134bc531f08e98868f70ea3e41e8fade80e62d,admin/preprints/views.py,1,2,2,2,4
CenterForOpenScience/osf.io,1849e881b800347680c9f7778829ca0b8a84fa09,admin/preprints/views.py,18,6,280,342,622
radiasoft/sirepo,01a90b2c5f7783e61f1aa16b1eaaa1c3330d70f0,sirepo/template/warppba.py,0,2,90,3,93
radiasoft/sirepo,48eb6a685f43ac18e8bb6184cd689455e6040331,sirepo/template/warppba.py,0,13,74,77,151
colour-science/colour,dd4e35c64d87c6a96f015b75c9ce16eae4e1d8c8,colour/appearance/kim2009.py,0,12,60,72,132
GPflow/GPflow,c42cd4772543dc0c3756620c8b407d8dbf2b2ee0,gpflow/conditionals/util.py,0,19,165,126,291
ray-project/ray,7f1bacc7dc9caf6d0ec042e39499bbf1d9a7d065,rllib/utils/spaces/space_utils.py,0,9,27,42,69
akkana/scripts,76c442db739813e0659472b5e034f5cc2e8caee9,vote411export.py,0,13,94,90,184
CompassionCH/compassion-switzerland,6f5458cf15bbcbf00b33db12bf4b31243217c6c9,partner_communication_switzerland/models/partner_communication.py,0,1,14,3,17
CompassionCH/compassion-switzerland,c7efaa68dd52b4949b9eb97c35ee29de3480a153,partner_communication_switzerland/models/partner_communication.py,2,3,1,39,40
CompassionCH/compassion-switzerland,384cbb12601896177350195fced7c67d9085a1f6,partner_communication_switzerland/models/partner_communication.py,0,0,0,0,0
CompassionCH/compassion-switzerland,ff16231333f7636c99a3d3da7a3307ee07f62a00,partner_communication_switzerland/models/partner_communication.py,6,20,273,166,439
openstack/python-openstackclient,201b1cee86a4df8ede6c97d962ac331ad0378140,openstackclient/image/v2/image.py,0,8,90,90,180
openstack/python-openstackclient,2290b38ab3d02ca67d6c2177fa9521720d48b0f0,openstackclient/image/v2/image.py,0,43,192,336,528
tensorflow/tensorflow,c99d3cd559fa250ef9a7adbbe5d27faff285ae4a,tensorflow/python/ops/control_flow_ops.py,0,0,0,0,0
tensorflow/tensorflow,9d5e437f3bd9bc6eb9b24d07d11bd7cd083e842e,tensorflow/python/ops/control_flow_ops.py,1,16,150,96,246
tensorflow/tensorflow,62e2653f1ca519a9c3feb430bf363ee996205f3c,tensorflow/python/ops/control_flow_ops.py,2,16,149,99,248
City-of-Helsinki/kerrokantasi,6ba29dc506f4048a1683b11832047d39ca025a16,democracy/models/images.py,0,1,1,1,2
catalyst-cooperative/pudl,11c813d779ddd6a221cd0ffbb6a3901ca61e2443,src/pudl/output/eia860.py,2,4,8,151,159
catalyst-cooperative/pudl,431c5873674cf184dc4f4f464df59dbb4fa4d894,src/pudl/output/eia860.py,0,29,191,210,401
scikit-learn/scikit-learn,5c85567172a5d56733014dc843c1b9d6e4aef19b,sklearn/ensemble/_hist_gradient_boosting/gradient_boosting.py,0,7,49,66,115
matrix-org/synapse,4806651744616bf48abf408034ab9560e33f60ce,synapse/push/bulk_push_rule_evaluator.py,0,4,5,5,10
matrix-org/synapse,7ca8ee67a5165e33f03454218c81be96397e7591,synapse/push/bulk_push_rule_evaluator.py,0,5,14,16,30
matrix-org/synapse,800ba87cc881856adae19ec40485578356398639,synapse/push/bulk_push_rule_evaluator.py,0,1,1,1,2
matrix-org/synapse,8ef324ea6f1390876940989eacc8734fe0d15582,synapse/push/bulk_push_rule_evaluator.py,0,3,14,4,18
diofant/diofant,ef0d3e7ecd05985750a20d6285f9fdce47b9616d,diofant/core/sympify.py,0,1,2,1,3
jclgoodwin/bustimes.org.uk,3e87d87cce6f297af42effa598c990e21a43c080,vehicles/utils.py,0,0,0,0,0
reviewboard/ReviewBot,14b53b94f730b7c8812b8871b793fb321bab8138,bot/reviewbot/tools/rustfmt.py,0,1,1,1,2
SimpleITK/SimpleITK,9e472d57e043a782ba33ee838373c96a736c9a1a,Examples/ImageRegistrationMethodBSpline2/ImageRegistrationMethodBSpline2.py,0,6,12,19,31
pedohorse/hpaste,45bdc0795686b3d254b01c1d9a17786a54a87d99,python2.7libs/hpaste/hpasteshelffunctions.py,2,3,5,21,26
pypa/pip,6c3853a325b89fb356100bfe595ddd4a7214cdae,src/pip/_vendor/requests/models.py,0,41,143,204,347
huggingface/transformers,81643edda55dcf9e050612dec285f2fd8d8833e2,src/transformers/hf_argparser.py,1,2,81,88,169
isard-vdi/isard,d48386ac05b5a8349eff9978ad555d6dd2de2e5c,api/src/api/libv2/api_desktops_persistent.py,0,7,20,41,61
City-of-Helsinki/kerrokantasi,6ba29dc506f4048a1683b11832047d39ca025a16,democracy/views/section.py,0,10,22,45,67
pytorch/vision,61f82669acb71b45c55b83b025f54062f24445f6,torchvision/models/detection/anchor_utils.py,0,1,11,8,19
librosa/librosa,1b97fb90bb0b0f2c3496f3506868474111f9b40a,librosa/core/audio.py,0,4,14,3,17
librosa/librosa,a3095313a2ba9e37e24f6180c4decc77cd6a2b0d,librosa/core/audio.py,1,5,32,62,94
jclgoodwin/bustimes.org.uk,7e8d93c7db6ff67cd1560649aed884c5cf31ce76,bustimes/management/commands/import_gtfs.py,0,0,0,0,0
jclgoodwin/bustimes.org.uk,4b18fbff1b6054696ca7b802d899627a0bffbe74,bustimes/management/commands/import_gtfs.py,0,0,0,0,0
e-mission/e-mission-server,5e53ee0fbf6e529500f874305c78bf53721c59be,emission/net/usercache/formatters/android/location.py,0,1,32,1,33
rpm-software-management/rpmlint,5fafa721a5e834083f0b2579901796e5280fae56,rpmlint/checks/BinariesCheck.py,0,5,14,3,17
frafra/is-osm-uptodate,bb1835049ab7ba207bc56e025a3fba4f809104c8,is-osm-uptodate.py,1,3,42,43,85
frafra/is-osm-uptodate,3c4a5821ed88b8355a403326b6d5db81ef22ea73,is-osm-uptodate.py,0,1,424,4,428
DIRACGrid/WebAppDIRAC,27fb9f70442ab883c0a02fc070a4fa425647328e,src/WebAppDIRAC/WebApp/handler/JobSummaryHandler.py,0,7,272,256,528
FCP-INDI/C-PAC,b458326748f515d96b69477fd3acb1dc136afc9e,CPAC/utils/interfaces/ants.py,16,0,0,0,0
FCP-INDI/C-PAC,cec1b77f90bf2eb4b93763b487681fed57aeda53,CPAC/utils/interfaces/ants.py,10,3,70,72,142
zynthian/zynthian-ui,0364e4afca7596559faa1f50c881d7efe0d159fb,zyngui/zynthian_gui_controller.py,0,24,157,199,356
zynthian/zynthian-ui,caa5b9365da62722333c0162de07aec2314769bb,zyngui/zynthian_gui_controller.py,1,10,89,52,141
qgis/QGIS,c36971066772a97a7faa2c47a2c755f4005ba527,python/plugins/processing/gui/BatchAlgorithmDialog.py,0,2,15,0,15
qgis/QGIS,185172a946d31292b98ecc18a1be54d68d5f3b87,python/plugins/processing/gui/BatchAlgorithmDialog.py,0,1,36,1,37
qgis/QGIS,092279e90def90c071f9efb63e66c763139e5d8f,python/plugins/processing/gui/BatchAlgorithmDialog.py,3,4,118,18,136
tweepy/tweepy,9051ba64bc0610c9e0027e53f6e32a72de67d1e2,tweepy/asynchronous/streaming.py,26,6,117,573,690
Alexey-T/CudaText,9eed9bdea80797b5a1739ee11a48e213e8debf22,app/py/sys/requests/models.py,0,41,146,214,360
quantumlib/Cirq,446b7ec04b3302689acf1c9d4e78c89d3a0b3a69,cirq-core/cirq/experiments/fidelity_estimation.py,0,2,161,1,162
DIRACGrid/WebAppDIRAC,5f4b939321755d1303ce41fb164d3410d0671f9d,src/WebAppDIRAC/WebApp/handler/SiteSummaryHandler.py,0,5,62,61,123
frappe/erpnext,494bd9ef78313436f0424b918f200dab8fc7c20b,erpnext/manufacturing/report/production_plan_summary/production_plan_summary.py,0,4,81,66,147
gitpython-developers/GitPython,21ec529987d10e0010badd37f8da3274167d436f,git/objects/fun.py,0,11,27,48,75
google/iree,41a2cebe9560fda8a3ef171bb2dd5f51434897f2,configure_bazel.py,0,1,3,0,3
demisto/content,aa5097a1135b6b6bd1aab12c7431969b9ccf5e18,Packs/RubrikPolaris/Integrations/RubrikPolaris/RubrikPolaris.py,69,1,640,2858,3498
indico/indico,aa0a0889ce6a4c7cf30035e767d341b7a0088e60,indico/modules/users/controllers.py,1,4,15,6,21
indico/indico,62a92f6d20ae24a3ea4688202164cb01803e67f1,indico/modules/users/controllers.py,7,17,68,67,135
indico/indico,dbc97c40e3a9db672992c48afe393f5b9a6fd719,indico/modules/users/controllers.py,2,2,14,31,45
indico/indico,583c895a5b99d3bb617e43f05b6b87e190cc7101,indico/modules/users/controllers.py,2,2,14,31,45
ECP-CANDLE/Benchmarks,8cc5e04b8a54060de8a707f9a6dd25f1ddd10db5,examples/image-vae/model.py,0,32,172,413,585
wikimedia/pywikibot-core,427a7d443bcda520448768f00768859cda19e77c,scripts/add_text.py,0,4,6,6,12
craws/OpenAtlas,23e60b4c643df5939ca39fe9724e2bc7373068ca,openatlas/forms/form.py,0,3,4,7,11
craws/OpenAtlas,f72c6d729c647e8b0869312ff5e15e0f13221e29,openatlas/forms/form.py,1,3,99,126,225
PMEAL/OpenPNM,8fb250098bb7473e0f393a68da31bceacd27b310,openpnm/topotools/_topotools.py,0,10,834,110,944
spesmilo/electrum,196b4c00a35b288f28885c0ceb8afdd5ffbd9a0f,electrum/trampoline.py,0,4,17,9,26
explosion/spaCy,b92f81d5da43da759e44f1e1c6859805873546a4,spacy/pipeline/entity_linker.py,0,10,14,15,29
explosion/spaCy,e9eb59699f1b80c7a74b9e0f1bb2520d74b7bfd5,spacy/pipeline/entity_linker.py,0,9,7,27,34
voxpupuli/puppetboard,f187638b6eb673a18d3b165a34eaddf336720a09,puppetboard/app.py,0,2,29,24,53
voxpupuli/puppetboard,d879ab7a8cc0bcc94893844bbad277b355c7c6b5,puppetboard/app.py,0,1,18,16,34
voxpupuli/puppetboard,3020dbf1efa91fb31230d7d50ea2c3efb9a6faa6,puppetboard/app.py,0,3,458,4,462
voxpupuli/puppetboard,7d7d5f9a2a58bbf754e406b8574cd22de4f36b60,puppetboard/app.py,0,3,97,4,101
colour-science/colour,3fc4e2dd6f26f875aee9f9e8f8afb39eee285fe9,colour/appearance/nayatani95.py,21,2,157,918,1075
colour-science/colour,dd4e35c64d87c6a96f015b75c9ce16eae4e1d8c8,colour/appearance/nayatani95.py,0,21,82,101,183
gkunter/coquery,55ee59b748e33f62a0100230b2244bf6b3b4fac5,coquery/managers.py,5,34,224,325,549
coreboot/chrome-ec,961062d7f72dd5b2bee75c013f03d7c0a47291bf,zephyr/zmake/zmake/zmake.py,0,7,44,9,53
tensorflow/federated,9160d937d1f54118f5ac99fbfef565419ac8a534,tensorflow_federated/python/core/impl/compiler/tree_transformations.py,0,5,871,0,871
protwis/protwis,1dc064ddeb1f3b9bed2126964d2e761938497691,ligand/functions.py,0,1,159,159,318
protwis/protwis,86d61af715f43dac1f7daf4495e7321203a993a4,ligand/functions.py,0,9,189,166,355
buildbot/buildbot,85e1ecfec4b7f987841a1e03193181bb30cd8fbe,master/buildbot/reporters/words.py,0,1,3,1,4
buildbot/buildbot,679770715f6e643fb5b3da19fc724218b63e86dd,master/buildbot/reporters/words.py,0,1,1,1,2
facebook/fbthrift,cc0e488888eda02278cb342bb488ade7c7b62e95,thrift/lib/py/protocol/TJSONProtocol.py,0,16,61,74,135
numba/numba,8d3027821ffb730d253933d9b1581530100fcfcc,numba/cuda/compiler.py,0,5,19,7,26
numba/numba,d2b044d2448f27463e61bb7b05521e4d3bb76fb0,numba/cuda/compiler.py,6,14,221,156,377
numba/numba,48f9c300188e1920697332733b3d145c07a1c434,numba/cuda/compiler.py,0,1,0,3,3
numba/numba,b918471aa1d3ae60f5c1370d6a202b30912d523d,numba/cuda/compiler.py,0,1,8,10,18
numba/numba,e8610c44977fb4578f436fdb78d5f7136ea7a9b4,numba/cuda/compiler.py,1,2,6,3,9
DOAJ/doaj,4b5e56fbe54e39ac20dc49ea4349d0f707a4d449,portality/background.py,0,0,0,0,0
wagtail/wagtail,0d8ad857bf9bcf11fe64c1b814bb4040a54e5a8e,wagtail/admin/views/pages/search.py,1,2,16,27,43
wagtail/wagtail,9943b74c335f3b9c1f093769c01ef8500ac1c450,wagtail/admin/views/pages/search.py,0,6,7,0,7
wagtail/wagtail,d554cbe3103028094e095b4512323ca2967aca4a,wagtail/admin/views/pages/search.py,5,4,58,59,117
SimpleITK/SimpleITK,9e472d57e043a782ba33ee838373c96a736c9a1a,Examples/ImageRegistrationMethod1/ImageRegistrationMethod1.py,0,4,6,14,20
mongodb/mongo-python-driver,7f4c504560e28e5255c834f8e638c585ed764b83,pymongo/command_cursor.py,0,3,63,19,82
mongodb/mongo-python-driver,5578999a90e439fbca06fc0ffc98f4d04e96f7b4,pymongo/command_cursor.py,0,12,51,58,109
frappe/erpnext,13ec41abb27ce77e66c9c5d938de9d48ea1b3e44,erpnext/projects/doctype/task/task.py,0,0,0,0,0
frappe/erpnext,494bd9ef78313436f0424b918f200dab8fc7c20b,erpnext/projects/doctype/task/task.py,0,12,88,164,252
ECP-CANDLE/Benchmarks,8cc5e04b8a54060de8a707f9a6dd25f1ddd10db5,Pilot1/Attn/attn_abstention_keras2.py,0,10,221,407,628
ccxt/ccxt,3b95e949641cf892526f5e54ff6a4984642366c3,python/ccxt/currencycom.py,0,3,22,4,26
ccxt/ccxt,800d7a79f2a76b516e9ab31df274efc6daa3bebd,python/ccxt/currencycom.py,1,2,1,64,65
ECP-CANDLE/Benchmarks,8cc5e04b8a54060de8a707f9a6dd25f1ddd10db5,Pilot1/Uno/uno_trainUQ_keras2.py,0,5,250,417,667
rackerlabs/django-DefectDojo,878ef9c777ba5acd4793791944c24b699b748b4d,dojo/user/views.py,0,2,24,0,24
rackerlabs/django-DefectDojo,5a2928fe954609a31d92306aa9e0470edea30a54,dojo/user/views.py,0,1,1,1,2
astropy/astropy,bc8dbdf4cccd1e4864706cdffcde9bc42a812972,astropy/utils/state.py,5,3,25,28,53
luci/luci-py,9fd5e4cc9c03a257287f06bb86b6bb6f08f51087,appengine/third_party/gae_ts_mon/config.py,2,3,8,66,74
Alexey-T/CudaText,9eed9bdea80797b5a1739ee11a48e213e8debf22,app/cudatext.app/Contents/Resources/py/sys/requests/models.py,0,41,146,214,360
deepmind/dm_robotics,20effd7d12a6a209ff15a963df83e5e0d68486df,py/transformations/transformations.py,0,1,1618,82,1700
MIT-LCP/wfdb-python,70a1a6b6ba0fe3e954e91fe21d68200a6f19886c,wfdb/processing/peaks.py,0,1,363,0,363
MIT-LCP/wfdb-python,3b408f23f50889c7d1c6fee9329c76b739b9f667,wfdb/processing/peaks.py,0,4,42,54,96
ray-project/ray,7f1bacc7dc9caf6d0ec042e39499bbf1d9a7d065,python/ray/_private/utils.py,0,30,117,156,273
colour-science/colour,dd4e35c64d87c6a96f015b75c9ce16eae4e1d8c8,colour/models/rgb/transfer_functions/cineon.py,0,3,16,18,34
python-poetry/poetry-core,0904607b405185a37acb34e77f6d2fe597927e8e,src/poetry/core/_vendor/lark/exceptions.py,8,1,47,220,267
f-droid/fdroidclient,3c874f231142073eb058c138df6b116c61715bdf,tools/pick-complete-translations.py,0,3,6,15,21
facebookresearch/ParlAI,4f7b38e7970424e4329cb57ab65710291a50f3f7,parlai/tasks/empathetic_dialogues/agents.py,4,4,173,69,242
diofant/diofant,279c0d44d7ceb0fe32f19268ff6f3574df7d8839,diofant/core/function.py,0,1,1,1,2
sqlalchemy/sqlalchemy,18a73fb1d1c267842ead5dacd05a49f4344d8b22,lib/sqlalchemy/orm/relationships.py,4,104,340,664,1004
cmjatai/cmj,63998f6fb7ea449e64bf5c681e94a046a680818a,cmj/videos/models.py,0,2,3,2,5
couchbase/couchbase-python-client,6d305796b094024c2ea07c8c963899999420f610,acouchbase/management/queries.py,10,5,497,100,597
wikimedia/pywikibot-core,98b85fed7ac3175accebe864d8da9f0122f21e37,pywikibot/site/_generators.py,0,1,1,1,2
radiasoft/sirepo,6d5fff7f110547a399c90948e0d1f959b15620fb,sirepo/sim_data/radia.py,0,1,0,10,10
radiasoft/sirepo,c12e6b387f28356e91aa9338389dfb7325dfdc24,sirepo/sim_data/radia.py,1,4,25,47,72
frappe/erpnext,fc26f640116faeea734ca4a0f5c5a4a51d631561,erpnext/stock/doctype/stock_reconciliation/stock_reconciliation.py,7,1,266,142,408
frappe/erpnext,fa006402b897f9d5a003fa992d2bbb9b88cbf08c,erpnext/stock/doctype/stock_reconciliation/stock_reconciliation.py,3,1,28,82,110
frappe/erpnext,4038977e2ed3f5e33b8c7151896c79ed3043981b,erpnext/stock/doctype/stock_reconciliation/stock_reconciliation.py,0,1,0,1,1
frappe/erpnext,494bd9ef78313436f0424b918f200dab8fc7c20b,erpnext/stock/doctype/stock_reconciliation/stock_reconciliation.py,0,32,172,272,444
ccxt/ccxt,f9f8f1960128830b36281acb0f2005c2f364c70b,python/ccxt/luno.py,0,2,19,42,61
schemaorg/schemaorg,06c03957d4915e4689690ee7f00d8438fa876234,software/util/buildsite.py,0,9,44,11,55
ufo-kit/concert,0b8f6b0c379b82d899fc54dab02159538267fb32,concert/session/utils.py,0,2,24,0,24
mongodb/mongo-python-driver,280efd2d726aa589b8656031f3453d0a7903e1ff,pymongo/message.py,0,4,49,21,70
mongodb/mongo-python-driver,11752ed594f8d0fd3dac342b01b6c2e1a594e458,pymongo/message.py,1,21,425,35,460
mongodb/mongo-python-driver,5578999a90e439fbca06fc0ffc98f4d04e96f7b4,pymongo/message.py,0,41,316,414,730
frappe/erpnext,eef9cf152f1db8fcc8cfa23e8f51a7735c70637b,erpnext/stock/doctype/item/item.py,0,10,280,1,281
frappe/erpnext,f9929ed8a6465151d6ed996af8006c9096e99c8e,erpnext/stock/doctype/item/item.py,0,16,362,10,372
frappe/erpnext,b5abf68b0d462181b9a7625d640492dc74e5c71d,erpnext/stock/doctype/item/item.py,4,18,373,73,446
frappe/erpnext,6cd7c47409cc24bd3e8b7dfc9652934b97e32430,erpnext/stock/doctype/item/item.py,4,19,373,73,446
ccxt/ccxt,3b95e949641cf892526f5e54ff6a4984642366c3,python/ccxt/async_support/currencycom.py,0,3,22,4,26
ccxt/ccxt,800d7a79f2a76b516e9ab31df274efc6daa3bebd,python/ccxt/async_support/currencycom.py,1,2,1,64,65
SimpleITK/SimpleITK,9e472d57e043a782ba33ee838373c96a736c9a1a,Examples/Python/FFTConvolution.py,0,1,1,1,2
spesmilo/electrum,6a74ffe80e663adff2bc861ef284e2d7778ecda8,electrum/gui/qt/address_dialog.py,0,3,8,3,11
alisw/alibuild,86225692b0983664a1b2bcdb9544ad44a5c43ba8,alibuild_helpers/workarea.py,0,2,30,26,56
coreboot/chrome-ec,7540e7b47b55447475bb8191fb3520dd67cf7998,util/config_option_check.py,0,2,334,359,693
MozillaSecurity/FuzzManager,bb12ebd389864bbba8c2c9e15ab808efae54e660,FTB/CoverageHelper.py,0,14,50,84,134
scikit-learn/scikit-learn,a794c58692a1f3e7a85a42d8c7f7ddd5fcf18baa,sklearn/semi_supervised/_self_training.py,1,8,15,13,28
google/timesketch,db986692f1f73614290ba9116f0d28d6b1c01062,timesketch/lib/charts/barchart.py,0,4,12,10,22
Patrick-Cole/pygmi,01984717d0c90e45bf0f54c0d2c32e4f656efdff,pygmi/raster/modest_image.py,0,0,0,0,0
Patrick-Cole/pygmi,49da068f4db4724e1b9743d0f187bc422ba63715,pygmi/raster/modest_image.py,0,0,0,0,0
Patrick-Cole/pygmi,5ebef9ad62bad2047c60edc7bf63f341cc802159,pygmi/raster/modest_image.py,0,0,0,0,0
Patrick-Cole/pygmi,9f80425199fa2dd7d5c7b06914e23a3886dfa948,pygmi/raster/modest_image.py,1,14,53,52,105
NetworkManager/NetworkManager-ci,5d636626f0409de24fb9c491c3cc93d7663d15b9,run/centos-ci/node_runner.py,0,2,17,34,51
NetworkManager/NetworkManager-ci,849cace993e2c6ff36b02b3cf232ad3715f1db1c,run/centos-ci/node_runner.py,48,1,465,733,1198
NetworkManager/NetworkManager-ci,b5aaa6907a347dc438147a23b9dc7657608922d9,run/centos-ci/node_runner.py,2,4,38,65,103
python-control/python-control,7bed77f2526dc5b9fde4870e035b7a64a3e81448,control/xferfcn.py,0,6,143,110,253
python-control/python-control,e2f76df5e6ae2f562a8040ad33f1ea40838994d3,control/xferfcn.py,0,17,62,109,171
python-control/python-control,c913c8f02bf75ed87108bba221f01e70aade446e,control/xferfcn.py,0,10,9,25,34
python-control/python-control,6df091928493338b1ea2a96c91063f5778356554,control/xferfcn.py,3,30,131,148,279
couchbase/couchbase-python-client,9e273da04c5f46730ca39efa4097ae33eec00803,couchbase/cluster.py,2,40,265,352,617
couchbase/couchbase-python-client,373302bc20e94cf87b788142f9f58caf488c2cdf,couchbase/cluster.py,0,2,2,4,6
matrix-org/synapse,e44f91d678e22936b7e2f0d8bf4890159507533b,synapse/handlers/search.py,5,6,219,424,643
jnewland/ha-config,980d7f7bc19db0f43d364bfb934727a656cb3b95,custom_components/bhyve/switch.py,1,22,49,127,176
frappe/erpnext,494bd9ef78313436f0424b918f200dab8fc7c20b,erpnext/accounts/doctype/tax_withholding_category/tax_withholding_category.py,0,12,178,260,438
wagtail/wagtail,d10f15e55806c6944827d801cd9c2d53f5da4186,wagtail/admin/views/collection_privacy.py,0,3,20,29,49
pytorch/text,d0169aee74c442d05ab4e0f3b4df0c80245e4cf0,torchtext/experimental/vectors.py,0,9,19,35,54
pytorch/text,c31a400990513d180fdbd4ae5d597781b6b7063a,torchtext/experimental/vectors.py,0,6,392,206,598
DesertBot/DesertBot,7fd04d2fa53b9d9b1bab043800c81fdcffb24273,desertbot/modules/urlfollow/Imgur.py,0,2,13,2,15
nilouco/dpAutoRigSystem,b66e3f7b1e202522eae4b997b1c999de13266456,dpAutoRigSystem/Modules/dpSingle.py,0,4,10,0,10
FCP-INDI/C-PAC,388782ab1c0eb15c4a47da345db05fd666ac5c5b,CPAC/pipeline/engine.py,0,11,11,34,45
FCP-INDI/C-PAC,6a4da01505118701b358368b7adfe2f711bc30d4,CPAC/pipeline/engine.py,0,9,93,130,223
FCP-INDI/C-PAC,be22ce92a458b1034ebbadfd84830400711d3a73,CPAC/pipeline/engine.py,0,2,5,5,10
FCP-INDI/C-PAC,1670903ae3aedf86f2b9163abc0917cd2a4fba74,CPAC/pipeline/engine.py,0,3,20,4,24
GoogleCloudPlatform/gcpdiag,85972299e0298030031dcd7ed91aaafbe96c2dcd,gcpdiag/lint/command.py,2,8,11,71,82
tensorflow/similarity,d0c145cb4b358d1cbbc2cca9e09de8a56aa9d90e,tensorflow_similarity/evaluators/memory_evaluator.py,2,5,111,196,307
rocky/python-xdis,3dbaa78909afc9612e805840e3df2d8fa010db2c,xdis/opcodes/opcode_35.py,0,2,2,4,6
buildbot/buildbot,679770715f6e643fb5b3da19fc724218b63e86dd,master/buildbot/steps/source/repo.py,0,1,1,1,2
facebook/fbthrift,5df12e3ff80edc99921153b0218eaed0a96deb7c,thrift/lib/py/transport/THeaderTransport.py,1,2,73,80,153
facebook/fbthrift,faf9c2ffa5ae444b3e7a4836c87198b0c82f3838,thrift/lib/py/transport/THeaderTransport.py,0,25,97,118,215
oppia/oppia,8bf17962ea46f5db7a2cb201f6202f9569870889,core/domain/collection_domain.py,0,1,7,0,7
oppia/oppia,769ce2e2f8797bc077292395b11d2eb7b2b77484,core/domain/collection_domain.py,5,55,198,297,495
jim-easterbrook/Photini,d22418a913382977e6be8df34abba24a13dbf04c,src/photini/metadata.py,1,3,5,5,10
jim-easterbrook/Photini,3d89bd05e36ad55fba4259f4b118c6c1992e43d1,src/photini/metadata.py,0,6,19,31,50
jim-easterbrook/Photini,97b656068279d666a11e5bb6d58eb8144108839e,src/photini/metadata.py,45,14,465,429,894
jim-easterbrook/Photini,a70e5b6c03d72d37dd5abcabee37394f44f63bcd,src/photini/metadata.py,4,9,101,99,200
jim-easterbrook/Photini,0ef99a505068879b8b111f93b7c9be6e8f465287,src/photini/metadata.py,20,17,232,174,406
jim-easterbrook/Photini,0d732531ef3ae2ee3fae7736ddd9035cbc3d825e,src/photini/metadata.py,0,3,1096,20,1116
invesalius/invesalius3,13163add78ab61b1815767cccdf0887a559ab62e,invesalius/data/brainmesh_handler.py,3,7,59,99,158
molpopgen/fwdpy11,84f4f8ed12bc0b928df256ea71d923b346f89130,fwdpy11/_types/demography_debugger.py,5,5,496,196,692
google/timesketch,db986692f1f73614290ba9116f0d28d6b1c01062,timesketch/lib/analyzers/gcp_servicekey.py,0,3,21,23,44
google/brax,9d6b7ced2a13da0d074b5e9fbd3aad8311e26997,brax/envs/humanoid.py,2,26,111,313,424
fabioz/Pydev,89c9e747e052957de792eef2127b6574db1aa2be,plugins/org.python.pydev.core/pysrc/pydevconsole.py,0,5,12,5,17
python-poetry/poetry-core,0904607b405185a37acb34e77f6d2fe597927e8e,src/poetry/core/_vendor/lark/utils.py,7,9,154,168,322
scikit-rf/scikit-rf,868f19eca55f10220f0ccea674f72fe4e9ee66ea,skrf/vectorFitting.py,0,0,0,0,0
scikit-rf/scikit-rf,f1e663928768fe6fbe4dd8420b213a062c4a8bea,skrf/vectorFitting.py,0,0,0,0,0
OstapHEP/ostap,06f26cd0ab2c7ccda020f7ce8beb3dbfad781e52,ostap/fitting/utils.py,0,6,2555,13,2568
colour-science/colour,dd4e35c64d87c6a96f015b75c9ce16eae4e1d8c8,colour/appearance/hunt.py,0,25,159,221,380
h2oai/h2o-3,cb392e1770c508bd68ab1db2f25755ddda0eaa2f,h2o-py/h2o/model/metrics_base.py,1,0,0,0,0
gboeing/osmnx,130291de3ff3a755f848bc61cfcd1dbb79d9d787,osmnx/stats.py,0,1,88,0,88
akrherz/pyIEM,f4984ec186d2c765fc0a550b225df360f6a62b9d,src/pyiem/nws/products/saw.py,0,4,15,35,50
PyPSA/PyPSA,222116a4fdb2f6788371d8b1bc847bcdae7e0e33,examples/multi-decade-example.py,0,1,1,1,2
tornadoweb/tornado,f72d33f9648df064e6526348011f15e5425bfbde,tornado/autoreload.py,0,3,4,0,4
tornadoweb/tornado,bc68b8add400cd246281b6b65e05425641c15633,tornado/autoreload.py,0,1,14,3,17
saltstack/salt,f6f1333da9a9f201d2d9f7b3369d3393a384b4e1,salt/modules/win_file.py,0,6,137,81,218
wagtail/wagtail,d10f15e55806c6944827d801cd9c2d53f5da4186,wagtail/search/backends/database/postgres/postgres.py,0,27,102,188,290
corpnewt/CorpBot.py,63bc266de4bada799f4581bba84f2d607c5d9703,Cogs/VoteKick.py,0,12,142,14,156
wagtail/wagtail,e5f5b070fba327ff99999d170e3ba2550ce42f4d,wagtail/admin/wagtail_hooks.py,0,6,46,1,47
buildbot/buildbot,679770715f6e643fb5b3da19fc724218b63e86dd,master/buildbot/steps/http.py,0,1,1,1,2
apache/cassandra,634131961af9c1d88b34797c1c45000f71a76dae,pylib/cqlshlib/copyutil.py,0,18,25,23,48
ECP-CANDLE/Benchmarks,8cc5e04b8a54060de8a707f9a6dd25f1ddd10db5,common/parsing_utils.py,0,11,433,657,1090
yeatmanlab/pyAFQ,73756b8bb0acbc0490ea888d4935ae52774c6bc7,AFQ/tasks/data.py,0,3,8,2,10
shengqh/ngsperl,124e20a89eaa2d5fa592dca0c256bdb2fb8914eb,lib/scRNA/enclone_to_clonotype.py,7,5,69,126,195
DIRACGrid/WebAppDIRAC,7c4480b419dadce273c0d29b01c29b58e43177f1,src/WebAppDIRAC/WebApp/handler/TransformationMonitorHandler.py,0,1,389,294,683
frappe/erpnext,494bd9ef78313436f0424b918f200dab8fc7c20b,erpnext/assets/doctype/asset/asset.py,0,36,300,537,837
frappe/erpnext,6c29146c9183878a7a08db84cdc8e05a64c88455,erpnext/assets/doctype/asset/asset.py,0,2,48,8,56
SimpleITK/SimpleITK,9e472d57e043a782ba33ee838373c96a736c9a1a,Examples/DemonsRegistration1/DemonsRegistration1.py,0,3,3,5,8
frappe/erpnext,494bd9ef78313436f0424b918f200dab8fc7c20b,erpnext/support/doctype/service_level_agreement/service_level_agreement.py,0,27,213,314,527
candlepin/subscription-manager,835a6b80ee84237b0796ad464438e5b6e5ab0523,src/subscription_manager/printing_utils.py,0,1,1,1,2
buildbot/buildbot,679770715f6e643fb5b3da19fc724218b63e86dd,master/buildbot/data/base.py,0,1,1,1,2
streamlink/streamlink,424aac28f05806d8e54413956a95f4bb957acb49,src/streamlink_cli/utils/progress.py,12,1,149,157,306
HTTPArchive/beta.httparchive.org,0b582bd54b2e0fe8241849a9f0ab1f41af3ffcb6,main.py,0,3,92,17,109
apache/arrow,01e4ad095a7649afc7a7316447bc5cc1fd9679a2,dev/merge_arrow_pr.py,2,11,115,87,202
MalloyDelacroix/DownloaderForReddit,0e46bc728f4b7d2f8132ea64df0ba7d46a2bfc6a,DownloaderForReddit/gui/downloader_for_reddit_gui.py,0,1,5,3,8
ray-project/ray,7f1bacc7dc9caf6d0ec042e39499bbf1d9a7d065,python/ray/cluster_utils.py,0,13,42,59,101
frappe/erpnext,494bd9ef78313436f0424b918f200dab8fc7c20b,erpnext/stock/reorder_item.py,0,9,57,100,157
metabrainz/listenbrainz-server,043a39da40390558919d62d2f35e8648cf3fc62a,listenbrainz_spark/recommendations/recording/recommend.py,0,4,72,3,75
metabrainz/listenbrainz-server,f210cd74b7a669bbcb435df6f623e35e0cc807ed,listenbrainz_spark/recommendations/recording/recommend.py,1,14,129,84,213
metabrainz/listenbrainz-server,57d3fea01f8693317a6a07ac0c3d72fd67a28fe2,listenbrainz_spark/recommendations/recording/recommend.py,0,6,14,9,23
mne-tools/mne-python,93a3be5d21028331a88c42ef9dfa10566bcd6d1f,mne/utils/docs.py,0,1,1,6,7
PaddlePaddle/Paddle,187fcfa3f8a5d673f6328801fa4a346a320d64d7,python/paddle/tensor/einsum.py,0,7,169,91,260
pekrau/Publications,e998977e05ddc6937de9ee6f8229c3661b219614,publications/subset.py,0,16,62,87,149
wikimedia/pywikibot-core,c0a879b34163ba6b6dc8aa235d502baeea053ca4,pywikibot/proofreadpage.py,6,9,19,216,235
wikimedia/pywikibot-core,a5c7df5ffe4d027a91b2878c18a77414049abb3c,pywikibot/proofreadpage.py,2,3,0,33,33
wikimedia/pywikibot-core,98b85fed7ac3175accebe864d8da9f0122f21e37,pywikibot/proofreadpage.py,0,1,1,1,2
wikimedia/pywikibot-core,9b5f4540c453e5d5417e7060f664195b60938e57,pywikibot/proofreadpage.py,0,2,8,2,10
demisto/content,a28286210141ac9364c929c8d1c00b5974a9646a,Packs/Axonius/Integrations/Axonius/Axonius.py,5,6,61,144,205
radiasoft/sirepo,f7b8003b2a0fcb2b407809b0bee76f4e23508566,sirepo/template/raydata.py,0,4,77,10,87
radiasoft/sirepo,376bbc09ded62e299b01c540523b6314dae75a63,sirepo/template/raydata.py,1,3,3,40,43
radiasoft/sirepo,d788ac6577a5c722cc752a7d0e420d4f50bc034e,sirepo/template/raydata.py,0,3,1,14,15
radiasoft/sirepo,eed4786ea24fa25d438a59bf77dbdfd1df601362,sirepo/template/raydata.py,0,1,1,1,2
radiasoft/sirepo,48eb6a685f43ac18e8bb6184cd689455e6040331,sirepo/template/raydata.py,0,9,43,65,108
lowRISC/opentitan,75a2452b170e23caeb5e7d3e56496937c68b645a,hw/top_englishbreakfast/util/prepare_sw.py,3,2,115,95,210
SimpleITK/SimpleITK,9e472d57e043a782ba33ee838373c96a736c9a1a,Examples/ImageRegistrationMethod2/ImageRegistrationMethod2.py,0,4,9,18,27
ray-project/ray,56bab61fba44ec051befaca705fdca9ece70b745,python/ray/remote_function.py,0,2,26,14,40
ray-project/ray,7f1bacc7dc9caf6d0ec042e39499bbf1d9a7d065,python/ray/remote_function.py,0,10,108,171,279
rocky/python3-trepan,165213ca5c39e822379abb92b5c4f0df8769535b,trepan/lib/breakpoint.py,0,14,67,109,176
scalyr/scalyr-agent-2,3d6b733554f2089105509041fad5f150139758c3,scalyr_agent/third_party/urllib3/contrib/securetransport.py,4,29,103,218,321
scalyr/scalyr-agent-2,1d9f45b615aea44acae1392b1ca48827de1a5159,scalyr_agent/third_party/urllib3/contrib/securetransport.py,4,29,103,218,321
metabrainz/listenbrainz-server,16a61d1a0d142e453942cf110dfffc67deb7ce99,listenbrainz_spark/recommendations/recording/train_models.py,1,5,212,127,339
wikimedia/pywikibot-core,29b25c6acd99f952e98ce13f39fadf52ad72b4f4,scripts/fixing_redirects.py,2,3,85,71,156
wikimedia/pywikibot-core,eb99230f03a1158b884edb1902fa974daf89861c,scripts/fixing_redirects.py,0,1,6,3,9
pvlib/pvlib-python,edea6066d694dcdf2cdee8869f1326ad0c592a3f,pvlib/tools.py,0,2,107,0,107
pvlib/pvlib-python,9a6f76e99d76ff1204f7f08a73165d313136c4ab,pvlib/tools.py,0,2,30,40,70
frappe/erpnext,494bd9ef78313436f0424b918f200dab8fc7c20b,erpnext/accounts/doctype/exchange_rate_revaluation/exchange_rate_revaluation.py,0,8,75,119,194
FDio/vpp,d9b0c6fbf7aa5bd9af84264105b39c82028a4a29,extras/scripts/crcchecker.py,0,10,94,113,207
scikit-learn/scikit-learn,47dd54f727f09a47e84fb4cb53d33f9b0f239edb,sklearn/covariance/_elliptic_envelope.py,0,3,6,8,14
wechatpy/wechatpy,b99e94d0d9eec66e8b9e608c31cac077091ad4fc,wechatpy/client/api/invoice.py,0,21,34,54,88
NREL/hescore-hpxml,39d005c6b7008dd548eaf5b8243ec901a8da5a1e,hescorehpxml/base.py,0,9,22,29,51
NREL/hescore-hpxml,290af16c0ff82df1dab5d1c7f44dfbc96f0233cb,hescorehpxml/base.py,0,9,92,108,200
NREL/hescore-hpxml,ee7182b13cb057938dc695ffea934114239fe058,hescorehpxml/base.py,0,1,1,1,2
NREL/hescore-hpxml,d554be8db7dfa4b695cb913b4095bc584ae82af7,hescorehpxml/base.py,2,16,129,185,314
NREL/hescore-hpxml,f8ecf85ded36d7b9a4b7a9ac6350ccfc643d9fe9,hescorehpxml/base.py,2,18,136,210,346
NREL/hescore-hpxml,e1c233dd5ccba4e3b539be334b5297b68d3baaeb,hescorehpxml/base.py,0,1,29,29,58
NREL/hescore-hpxml,ed4b36e25368fb521f092810487c864f82957aac,hescorehpxml/base.py,0,1,8,4,12
NREL/hescore-hpxml,b97529dd23fe9b567193d99a3f3b37dfbe4a9b8c,hescorehpxml/base.py,0,1,1,1,2
mupif/mupif,8ca429cb34b50f9611d77b9dd26fdd892a91bdbd,mupif/pyroutil.py,2,24,79,83,162
mupif/mupif,fdc9d380d2c4f908f19032029f9793137914cc90,mupif/pyroutil.py,0,13,255,27,282
mujin/mujincontrollerclientpy,ff14f1d016f20d6abf1953fdb30f2a43c9b65e84,python/mujincontrollerclient/planningclient.py,1,1,0,5,5
mujin/mujincontrollerclientpy,d307bf2f52633347ea91cc7c0cb08a381195e121,python/mujincontrollerclient/planningclient.py,0,1,16,0,16
deepmind/dm_control,ae2d628c1437e5cf47211b964fb4039ecb456d46,dm_control/autowrap/binding_generator.py,0,7,13,55,68
automl/auto-sklearn,6e8dae1fa6b03d453456bb08e0db7a641e05ed32,autosklearn/automl.py,3,22,116,164,280
automl/auto-sklearn,f9db3c152759f5487aca66e976587b6245ce5d29,autosklearn/automl.py,0,7,159,18,177
automl/auto-sklearn,be2dfaf10d6cae138931134cde398b114d1cdcec,autosklearn/automl.py,0,70,454,603,1057
analyst-collective/dbt,f0f98be6929f6cf8f8906d6bdfd32b7be2863846,core/dbt/graph/selector_methods.py,0,3,41,22,63
ECP-CANDLE/Benchmarks,8cc5e04b8a54060de8a707f9a6dd25f1ddd10db5,common/calibration_main.py,0,6,109,185,294
bukun/TorCMS,69bbf4330817300104daa3fbf8278b91857c3d62,torcms/model/category_model.py,0,1,1,1,2
bukun/TorCMS,9623b6ba2f56ca1a7a2f1e7ee3ce592a9ea4df7f,torcms/model/category_model.py,0,3,11,12,23
nanophotonics/nplab,17b814f9783a8d463b58ebaa528a2dfd3483e68a,nplab/instrument/camera/thorlabs/kiralux.py,3,4,68,109,177
facebook/fbthrift,04d97a32c6d3d00c9ec8391bc48c9d93bb098a15,thrift/lib/py/util/Decorators.py,6,5,73,68,141
facebook/fbthrift,faf9c2ffa5ae444b3e7a4836c87198b0c82f3838,thrift/lib/py/util/Decorators.py,0,17,35,47,82
Keeper-Security/Commander,aef2ca1b503799a493ca88ee39af6e63256cb2bf,keepercommander/plugins/adpasswd/adpasswd.py,4,2,19,19,38
Keeper-Security/Commander,d1b8733ca2ef9129521d70144e400328107a6f63,keepercommander/plugins/adpasswd/adpasswd.py,1,1,37,81,118
FDio/vpp,d9b0c6fbf7aa5bd9af84264105b39c82028a4a29,src/plugins/srv6-mobile/extra/runner.py,0,74,362,462,824
anselmobd/fo2,1ac1ce45eb8edecdaedf7dd13b0e1f86bbfc0885,src/cd/views/etiq_solicitacoes.py,0,3,2,2,4
pvlib/pvlib-python,23236b21567ba688dacb4315d5462838dd0740ca,pvlib/tracking.py,0,6,22,0,22
pvlib/pvlib-python,c0daa5da20a9ba085ec02803b7cb170f4bb1e945,pvlib/tracking.py,1,6,77,70,147
ansible/ansible,699ecb83082b3b24a1a0a21cfadf19eda8891bff,lib/ansible/modules/service_facts.py,6,5,184,208,392
frappe/erpnext,c36524ec547046847197b0df185f8b3996c861ae,erpnext/accounts/doctype/account/chart_of_accounts/chart_of_accounts.py,0,2,19,1,20
frappe/erpnext,494bd9ef78313436f0424b918f200dab8fc7c20b,erpnext/accounts/doctype/account/chart_of_accounts/chart_of_accounts.py,0,11,46,92,138
protwis/protwis,d707944f42b6a370da330b32d3d2a7ff6bd6709a,ligand/models.py,4,6,366,301,667
protwis/protwis,86d61af715f43dac1f7daf4495e7321203a993a4,ligand/models.py,4,7,371,305,676
envoyproxy/nighthawk,c3daeef9312c848b2d76c2128602c112ab5ddfbd,tools/gen_compilation_database.py,0,1,74,79,153
mongodb/mongo-python-driver,5578999a90e439fbca06fc0ffc98f4d04e96f7b4,gridfs/grid_file.py,0,28,117,134,251
ToFuProject/tofu,565c091c3773b68fd1619b437747741d839be93f,tofu/data/_DataCollection_class.py,7,4,1056,105,1161
ToFuProject/tofu,4c0227a7302c70911d04f0464875dffdcc5fa548,tofu/data/_DataCollection_class.py,0,1,1535,1,1536
datajoint/datajoint-python,72ef4fdfbadadc00bfcd85e92dcb6380d0fd93ef,datajoint/diagram.py,0,15,85,197,282
matrix-org/synapse,800ba87cc881856adae19ec40485578356398639,synapse/handlers/room_member.py,0,1,2,2,4
openstack/neutron,0ddca284542aed89df4a22607a2da03f193f083c,neutron/agent/common/ovs_lib.py,1,2,23,22,45
buildbot/buildbot,679770715f6e643fb5b3da19fc724218b63e86dd,master/buildbot/changes/gerritchangesource.py,0,1,1,1,2
quodlibet/quodlibet,59220393001fb6b7c7c572c13f09884fc16a516d,quodlibet/ext/events/waveformseekbar.py,1,15,47,39,86
scikit-learn/scikit-learn,89772ff6e2faa55a612276114e9ba86225e22628,sklearn/ensemble/_bagging.py,0,6,7,30,37
scipy/scipy,df3db01069c8db8e483279a073fdd7b95c9f0fcc,dev.py,0,0,0,0,0
huggingface/transformers,f0aacc140bff272b12d234d598439e44074b67e4,src/transformers/models/pegasus/modeling_tf_pegasus.py,0,1,6,0,6
spectralDNS/shenfun,513ccc060635641d9cd5b40c5bb48a4b9a2c9387,shenfun/legendre/bases.py,4,34,185,63,248
frappe/erpnext,494bd9ef78313436f0424b918f200dab8fc7c20b,erpnext/accounts/doctype/share_transfer/share_transfer.py,0,3,144,184,328
dsavransky/EXOSIMS,1fddbf50c256358223aed477ce5363604166d0d1,EXOSIMS/util/CheckScript.py,0,5,38,83,121
googleapis/python-bigquery,76d88fbb1316317a61fa1a63c101bc6f42f23af8,google/cloud/bigquery/client.py,0,18,123,53,176
googleapis/python-bigquery,a2520cabf7ec6bcb923c21e338188f1c10dc4d5d,google/cloud/bigquery/client.py,2,17,50,71,121
riga/law,5dc74babe6cd793922658aa6a7bc338ac13b8c40,law/contrib/lsf/workflow.py,0,4,16,8,24
riga/law,c709f4c5892ad8bdb8de18c6c740b5ce18959e69,law/contrib/lsf/workflow.py,0,3,11,10,21
riga/law,0c84e87b67bd42824d21e5dc870a013a2c772373,law/contrib/lsf/workflow.py,0,3,56,45,101
wevote/WeVoteServer,4e2a77f7f01648726bbc1cf5b0e613cb7b1336b7,import_export_twitter/controllers.py,0,3,17,24,41
coreboot/chrome-ec,7540e7b47b55447475bb8191fb3520dd67cf7998,chip/mchp/util/pack_ec.py,0,6,400,485,885
genialis/resolwe-bio,561670c802ca9f377a312c8c57edbf783b98d1bb,resolwe_bio/processes/reads_processing/bqsr.py,0,3,14,1,15
hashview/hashview,24316264b6e04f34795601277cf1223303ea9956,hashview/wordlists/routes.py,0,1,1,1,2
wagtail/wagtail,9d584a20dcc1bd91d267a86af480325b338e07f0,wagtail/admin/views/pages/edit.py,1,5,24,48,72
wagtail/wagtail,d10f15e55806c6944827d801cd9c2d53f5da4186,wagtail/admin/views/pages/edit.py,0,31,242,367,609
Maselkov/GW2Bot,f647dc882d9fb880dd76c7d761c5a29143469cfb,guildwars2/database.py,0,4,75,50,125
Maselkov/GW2Bot,da0c4dc4213bade7f5f7c277ce718319f4a0901b,guildwars2/database.py,1,7,182,22,204
Maselkov/GW2Bot,5a7b2bf2174cd9a71b128019b524be7620a5b504,guildwars2/database.py,4,3,60,62,122
indico/indico,2b8edaa37be6990598b0411baf30af9dd9435604,indico/modules/events/registration/controllers/management/regforms.py,0,7,21,21,42
SimpleITK/SimpleITK,9e472d57e043a782ba33ee838373c96a736c9a1a,Examples/SimpleGaussian/SimpleGaussian.py,0,1,1,1,2
amccaugh/phidl,721460a7c4a6a7aa71c99f6fb5c28cc8e4a88f40,phidl/routing.py,0,28,682,1180,1862
amccaugh/phidl,38c905a41b1c12a195db262bd218a8e7a5be84a1,phidl/routing.py,0,28,688,1190,1878
amccaugh/phidl,32e9d687c0acb7137e2a8ee7697728f2312151a9,phidl/routing.py,0,3,891,0,891
fabioz/PyDev.Debugger,6caf1e69a5ad146b6612779d1731b1d92e6b8517,pydevconsole.py,3,5,77,153,230
fabioz/PyDev.Debugger,51f4ae23c75dfac83d8d22a6a197a94f126a92d2,pydevconsole.py,0,5,12,5,17
googlecolab/colabtools,6edd31f9928f4d06fa778f8dca057af59a2fb823,google/colab/_shell.py,0,0,0,0,0
googlecolab/colabtools,ab1bb0f928cc12647d1b8300fb10113df49fcf9e,google/colab/_shell.py,0,3,21,1,22
ray-project/ray,7f1bacc7dc9caf6d0ec042e39499bbf1d9a7d065,rllib/utils/exploration/per_worker_gaussian_noise.py,0,2,12,14,26
wagtail/wagtail,d10f15e55806c6944827d801cd9c2d53f5da4186,wagtail/admin/views/page_privacy.py,0,3,19,26,45
Cog-Creators/Red-DiscordBot,a80e20067ccbcf7e3ad8f7662451b03c3e2249e6,redbot/__main__.py,4,13,104,113,217
Cog-Creators/Red-DiscordBot,febca8ccbb10d4a618a20c5a25df86ca3532acb0,redbot/__main__.py,0,2,3,4,7
scikit-learn/scikit-learn,505380216d1d804750e96f60e7422152a37fb35e,sklearn/manifold/_t_sne.py,0,10,22,34,56
matrix-org/synapse,800ba87cc881856adae19ec40485578356398639,synapse/storage/databases/main/roommember.py,0,1,1,1,2
pantsbuild/pex,70a2caded62e12ff8ecd97b67d0ea2f89c16b60d,pex/tools/commands/venv.py,0,3,15,5,20
python-poetry/poetry-core,0904607b405185a37acb34e77f6d2fe597927e8e,src/poetry/core/_vendor/lark/parsers/lalr_parser.py,11,2,66,147,213
jjjake/internetarchive,64073730504b71f9745da5cc2f0da856f844ca30,internetarchive/cli/ia_tasks.py,0,2,14,13,27
corpnewt/CorpBot.py,63bc266de4bada799f4581bba84f2d607c5d9703,Cogs/XpBlock.py,0,4,80,6,86
rapydo/do,19801b2bd3c4d46c4ac05e14d48e6c462588ff0e,controller/commands/reload.py,0,3,15,10,25
kizniche/Mycodo,314a8fef06d066b64fd6944a7fbb89f17c061512,mycodo/mycodo_daemon.py,9,14,251,274,525
kizniche/Mycodo,cd1fdda41cdc86addae5ddc303f6cf4bc7a26b67,mycodo/mycodo_daemon.py,0,13,34,7,41
CenterForOpenScience/osf.io,2de37135714db1654d0cc35dd817b86830439c57,website/views.py,0,1,1,1,2
CenterForOpenScience/osf.io,f7fbd07c2387f8f932a2c64b82777836d496ec70,website/views.py,0,3,3,3,6
CenterForOpenScience/osf.io,8d5f2104a68f0dccf18e6469216c35f362b4b9b8,website/views.py,0,3,9,2,11
CenterForOpenScience/osf.io,0bb9975452b2ce29a8d0488ff8bb32e416f97262,website/views.py,0,0,0,0,0
CenterForOpenScience/osf.io,5c0f1dfe628eda89226765827dc4aba7c4cafca2,website/views.py,1,6,112,98,210
ccxt/ccxt,15f05546728b2fcaf7fbb29f9308629a2edadd9c,python/ccxt/novadax.py,0,3,35,58,93
tensorflow/tensorflow,a26aad7dcfa604506ba2c5aa76ee36dc9b6d701a,tensorflow/python/framework/ops.py,1,6,12,18,30
tensorflow/tensorflow,e8d8c8de81c7e5f98878c2953c39f968daace5b1,tensorflow/python/framework/ops.py,2,9,55,90,145
tensorflow/tensorflow,978a07bc7980e7198aedf485ec42912088f1d032,tensorflow/python/framework/ops.py,2,9,55,90,145
gkunter/coquery,9ba4cf4ab747fc3f825c32324aafed3d03ca7f36,coquery/sqlwrap.py,0,1,5,1,6
ECP-CANDLE/Benchmarks,8cc5e04b8a54060de8a707f9a6dd25f1ddd10db5,common/benchmark_def.py,0,5,67,83,150
nion-software/nionswift,c5606a453b7306c12c48dd77ccf88da2c4a28371,nion/swift/HistogramPanel.py,26,8,112,328,440
SimpleITK/SimpleITK,9e472d57e043a782ba33ee838373c96a736c9a1a,Examples/Python/ImageCreateAndSet.py,0,1,2,2,4
sony/nnabla,95ba32f80f5e6ced26f0c039957f18e127b7543e,python/src/nnabla/models/object_detection/yolov2.py,0,12,16,14,30
frappe/erpnext,494bd9ef78313436f0424b918f200dab8fc7c20b,erpnext/accounts/doctype/chart_of_accounts_importer/chart_of_accounts_importer.py,0,14,102,182,284
DFO-Ocean-Navigator/Ocean-Data-Map-Project,a5dafa05d3ac4a1e485ee440ec22ee644011a392,plotting/map.py,0,0,0,0,0
DFO-Ocean-Navigator/Ocean-Data-Map-Project,f1c6904b766d1e3569eba9dff1b551a8a6d2ad60,plotting/map.py,0,0,0,0,0
DFO-Ocean-Navigator/Ocean-Data-Map-Project,f3039dfa7412b4547336e67da437cb9e99311bcd,plotting/map.py,0,0,0,0,0
DFO-Ocean-Navigator/Ocean-Data-Map-Project,41159f45191e6faeb5bf701152594dca0a04ed51,plotting/map.py,0,0,0,0,0
DFO-Ocean-Navigator/Ocean-Data-Map-Project,0ae5aaa57097b22a017d1271ae624e0f2c7f9245,plotting/map.py,0,0,0,0,0
rhinstaller/anaconda,19fa2532125d15d64503e97b1d1ce39e8f2a8fca,pyanaconda/ui/gui/spokes/welcome.py,1,2,15,16,31
xupingmao/xnote,82d6522b2866e65998d1854dbfb5d45be351816a,app.py,1,4,20,17,37
xupingmao/xnote,40a49357b9552ef3dc39f54de38ac1e7877c5a04,app.py,0,0,0,0,0
xupingmao/xnote,bc387815bfd9920d658725856819a8b584aff59e,app.py,0,7,45,8,53
xupingmao/xnote,4f87b347074aca5ebc0d2cbac090ad866e3982af,app.py,0,1,359,3,362
astropy/photutils,3335915572a140e2bfb8fd50dfe6ebf4c7128cde,photutils/segmentation/catalog.py,3,4,11,95,106
astropy/photutils,af52b907f23ac63725f2c41503965eb125bd81c7,photutils/segmentation/catalog.py,2,15,41,44,85
astropy/photutils,8dae1e24ba846fc2dc12097658cb0e3c29459be5,photutils/segmentation/catalog.py,0,8,53,27,80
astropy/photutils,25fda1e8e2be9528cee31f7d6bb60567f6a50917,photutils/segmentation/catalog.py,0,6,17,25,42
StartupsPoleEmploi/labonneboite,fa3dd6404bb15e99ca5f65d8360e7406b89f0be3,labonneboite/common/util.py,1,3,17,10,27
StartupsPoleEmploi/labonneboite,d3d212590286f6ff7c1ee03ca30fb7949f6d707a,labonneboite/common/util.py,1,4,20,21,41
StartupsPoleEmploi/labonneboite,a6b2f9bcc77f1468e3679458f16f5716b771cee4,labonneboite/common/util.py,0,8,47,18,65
tensorflow/probability,913085acf56c19436ed59f863eb2985d973d90a5,tensorflow_probability/python/bijectors/softfloor.py,0,4,8,17,25
google/pigweed,00efe188a1fb361067d3bf73d4ad5885b2cfc453,pw_watch/py/pw_watch/watch.py,1,13,100,116,216
google/pigweed,d4a847efe877181891c6e1109b62c118fa9aa81a,pw_watch/py/pw_watch/watch.py,2,5,39,43,82
google/pigweed,e2dc38c7881a55cba8eaf1489f0337d06bdcf858,pw_watch/py/pw_watch/watch.py,3,15,36,116,152
spesmilo/electrum,f5b1f7d2d9ea2f344593106ba98ff0c72b7dccf8,electrum/gui/qt/channel_details.py,3,5,40,75,115
huggingface/transformers,1690094bdb8f606685e46f26c17ddadb925d0a20,src/transformers/trainer_pt_utils.py,0,1,7,2,9
ECP-CANDLE/Benchmarks,8cc5e04b8a54060de8a707f9a6dd25f1ddd10db5,examples/ADRP/reg_go2.py,0,8,88,116,204
fujicoin/fujicoin,309eac9019c224dfd79a78e381cfcb70fee190f3,contrib/devtools/symbol-check.py,0,5,55,34,89
gitpython-developers/GitPython,21ec529987d10e0010badd37f8da3274167d436f,git/objects/tree.py,0,21,57,101,158
alphagov/notifications-api,dd213b8d5543230bf47a9de1c8c9eb0cb4a5cb6a,app/schemas.py,0,2,2,1,3
ray-project/ray,7f1bacc7dc9caf6d0ec042e39499bbf1d9a7d065,python/ray/autoscaler/_private/resource_demand_scheduler.py,0,31,201,291,492
DFO-Ocean-Navigator/Ocean-Data-Map-Project,44ae7e344ed3a3aabea0ecbc8691ab57bc7554c8,plotting/hovmoller.py,0,0,0,0,0
DFO-Ocean-Navigator/Ocean-Data-Map-Project,0ae5aaa57097b22a017d1271ae624e0f2c7f9245,plotting/hovmoller.py,0,0,0,0,0
legacysurvey/legacypipe,32b92b557c61365f38cea39ca1b69695b5228630,py/legacypipe/worker.py,2,4,45,88,133
apache/allura,3cf7c6ec731b0fc15553a7c9447c9e8dd3851bb7,ForgeDiscussion/forgediscussion/controllers/root.py,0,1,1,3,4
SimpleITK/SimpleITK,9e472d57e043a782ba33ee838373c96a736c9a1a,Examples/Python/NeighborhoodConnectedImageFilter.py,0,4,5,8,13
mne-tools/mne-python,5387316b1e8fc0d31bc52993885f2ae77f774463,mne/decoding/base.py,0,8,31,21,52
mne-tools/mne-python,93c144e562c81489766eeb4cb98766534a8576af,mne/decoding/base.py,0,1,1,1,2
isard-vdi/isard,61c299408d450e665c191b5386dc973f6f7f0607,engine/engine/engine/services/lib/qcow.py,0,2,37,0,37
ECP-CANDLE/Benchmarks,8cc5e04b8a54060de8a707f9a6dd25f1ddd10db5,Pilot1/Uno/uno_contamination_keras2.py,0,8,228,376,604
Parallel-in-Time/pySDC,8c619b4b085a858222c766b9ea40ccf7a664469e,pySDC/implementations/controller_classes/controller_nonMPI.py,8,2,354,354,708
Parallel-in-Time/pySDC,9dd2e44e7291fdad9ba3503e514e41ef539de8f0,pySDC/implementations/controller_classes/controller_nonMPI.py,8,2,355,354,709
frappe/erpnext,494bd9ef78313436f0424b918f200dab8fc7c20b,erpnext/accounts/doctype/process_statement_of_accounts/process_statement_of_accounts.py,0,6,110,159,269
ray-project/ray,7f1bacc7dc9caf6d0ec042e39499bbf1d9a7d065,python/ray/tune/schedulers/hyperband.py,0,22,72,88,160
openstax/openstax-cms,13559ad98280f41fd2aa8fe8d354448be6bb1a9a,webinars/wagtail_hooks.py,0,1,1,3,4
jclgoodwin/bustimes.org.uk,350c0f6992ccf00a0a4be1bdf9cb44b830457997,transxchange/txc.py,0,0,0,0,0
matrix-org/synapse,ed25abe05fe3c6509b8245cb760cb7098dd8de72,synapse/handlers/message.py,0,1,1,1,2
matrix-org/synapse,800ba87cc881856adae19ec40485578356398639,synapse/handlers/message.py,0,1,1,1,2
isard-vdi/isard,ffe412dd26e026ac6b87505883510f2eded05e97,api/src/api/libv2/api_users.py,15,11,74,215,289
isard-vdi/isard,2256e9a411b07c1bea908e451fe32193e6feae60,api/src/api/libv2/api_users.py,1,6,55,80,135
corradio/electricitymap,93100551d23423d3889b8884b80e7f42ecb01f4a,parsers/lib/quality.py,0,2,77,119,196
SimpleITK/SimpleITK,9e472d57e043a782ba33ee838373c96a736c9a1a,Examples/ImageRegistrationMethodBSpline3/ImageRegistrationMethodBSpline3.py,0,6,17,24,41
ECP-CANDLE/Benchmarks,8cc5e04b8a54060de8a707f9a6dd25f1ddd10db5,Pilot1/Uno/uno_clr_keras2.py,0,16,171,344,515
scikit-learn/scikit-learn,75a94f518f7bd7d0bf581ffb67d9f961e3c4efbc,sklearn/linear_model/_glm/glm.py,12,19,215,208,423
Nic30/hwtHls,01f91c20e7ec964dc86a4184b4d4b42b2302ee84,hwtHls/ssa/translation/toLlvm.py,0,5,17,23,40
udapi/udapi-python,c691804af00366f60af2cac8fd5823404e1f83bc,udapi/core/coref.py,19,10,144,652,796
huggingface/transformers,29d49924538309ce1ccd1c1debb6dae439b020fe,src/transformers/models/bart/modeling_tf_bart.py,0,21,181,169,350
huggingface/transformers,7f28613213b39a9ae831dfc68783aa1718ec0697,src/transformers/models/bart/modeling_tf_bart.py,0,32,213,111,324
huggingface/transformers,f0aacc140bff272b12d234d598439e44074b67e4,src/transformers/models/bart/modeling_tf_bart.py,0,1,6,0,6
Harmon758/Harmonbot,8d47fb483ac674ade3b54dd5f60608215f4e6174,Discord/cogs/games.py,0,1,4,1,5
Harmon758/Harmonbot,40eef66756c252ae43ad16faa31a4ce404720205,Discord/cogs/games.py,0,5,79,1,80
jim-easterbrook/Photini,da227ca5dd1444c4b9188d9d12531c0141f46e7e,src/photini/ipernity.py,0,1,6,2,8
jim-easterbrook/Photini,efc15f98f8c0eafd0dee459bcbb4a7cd63632941,src/photini/ipernity.py,0,3,2,2,4
jim-easterbrook/Photini,7ca2252a6f05ffd1da43fe4d8b177c26f7edc416,src/photini/ipernity.py,0,2,24,29,53
schemaorg/schemaorg,06c03957d4915e4689690ee7f00d8438fa876234,software/util/buildocspages.py,0,7,38,9,47
SimpleITK/SimpleITK,9e472d57e043a782ba33ee838373c96a736c9a1a,Examples/HelloWorld/HelloWorld.py,0,2,4,7,11
matrix-org/synapse,4bd597d9fcb8e6c6888ee3e8fa683ba812272997,synapse/handlers/e2e_keys.py,0,3,20,12,32
matrix-org/synapse,926ba76e23ea9d55638baff541cdfaeb9e01ac47,synapse/handlers/e2e_keys.py,0,6,18,9,27
matrix-org/synapse,c2a5cf2fe32d2cd582711669b7c0ce74682e1c05,synapse/handlers/e2e_keys.py,1,4,28,25,53
matrix-org/synapse,af784644c3380d0a2ea885abbe748fbe69d3a990,synapse/handlers/e2e_keys.py,1,2,86,125,211
matrix-org/synapse,800ba87cc881856adae19ec40485578356398639,synapse/handlers/e2e_keys.py,0,2,2,2,4
openstack/tempest,1ff7748623c2d02122bec36542f8bc310d296836,tempest/lib/base.py,0,3,31,0,31
couchbase/couchbase-python-client,6d305796b094024c2ea07c8c963899999420f610,couchbase/management/buckets.py,0,2,428,52,480
tgbugs/pyontutils,b58e4a1e7898876aeb176cfc6de6110a0d3dd25f,ttlser/ttlser/ttlfmt.py,0,3,5,0,5
MontrealCorpusTools/Montreal-Forced-Aligner,6ee755d8a1f37fb7090146328d40ed27f35e7b8e,montreal_forced_aligner/corpus/classes.py,5,9,1107,125,1232
matrix-org/synapse,7754af24ab163a3666bc04c7df409e59ace0d763,synapse/federation/federation_client.py,1,4,194,32,226
wikimedia/pywikibot-core,98b85fed7ac3175accebe864d8da9f0122f21e37,pywikibot/tools/djvu.py,0,1,1,1,2
candlepin/subscription-manager,835a6b80ee84237b0796ad464438e5b6e5ab0523,src/subscription_manager/managerlib.py,0,27,72,115,187
MontrealCorpusTools/Montreal-Forced-Aligner,6ee755d8a1f37fb7090146328d40ed27f35e7b8e,montreal_forced_aligner/transcription/transcriber.py,2,42,201,326,527
PyPSA/PyPSA,e754928e4a84b30fb1741965e4c0c1299fea7f5a,pypsa/plot.py,0,5,6,15,21
MozillaSecurity/FuzzManager,bb12ebd389864bbba8c2c9e15ab808efae54e660,server/crashmanager/models.py,0,26,75,143,218
zentralopensource/zentral,3888ce4f26ce3687be0af664cbc3e4299127bcf5,zentral/core/stores/backends/elasticsearch.py,1,1,730,8,738
PMEAL/OpenPNM,85201f8a740566d6f3132a4d632378f8dd5b9c1c,openpnm/algorithms/_invasion_percolation.py,1,5,64,48,112
huggingface/transformers,f0aacc140bff272b12d234d598439e44074b67e4,src/transformers/models/blenderbot_small/modeling_tf_blenderbot_small.py,0,1,6,0,6
huggingface/transformers,050e0b44f6a63131b56d493543ab39fb7b4f20ca,src/transformers/models/blenderbot_small/modeling_tf_blenderbot_small.py,8,14,21,135,156
frappe/erpnext,494bd9ef78313436f0424b918f200dab8fc7c20b,erpnext/patches/v11_0/add_item_group_defaults.py,0,3,23,27,50
PyCQA/pylint,dfd23f61d5da4d8531a10f0d829ab5b05bce292e,pylint/checkers/non_ascii_names.py,0,3,14,1,15
hildogjr/KiCost,1dc55e3d360d365e1a3f744f920afa2123b9a463,kicost/distributors/dist_local_template.py,0,0,0,0,0
hildogjr/KiCost,a41d2eb5b1e8d0a25406eb42d11199a37ec17ed6,kicost/distributors/dist_local_template.py,0,1,12,0,12
hildogjr/KiCost,2c635981cfca5353f8d7987071fcb4333ca96626,kicost/distributors/dist_local_template.py,1,3,8,13,21
PMEAL/OpenPNM,5c791dae9f21dbdc9f7267fc36d41c4400ab6ba3,openpnm/topotools/_graphtools.py,0,3,271,15,286
nilouco/dpAutoRigSystem,b66e3f7b1e202522eae4b997b1c999de13266456,dpAutoRigSystem/Modules/dpFoot.py,0,1,8,6,14
ecederstrand/exchangelib,9907678f85866a0479302cf16ea8c7bbee347099,exchangelib/util.py,3,4,75,77,152
ecederstrand/exchangelib,e0492ac38f1f97210d14e4ccfd1cd841157e0233,exchangelib/util.py,1,3,9,12,21
ecederstrand/exchangelib,07eb7168586ac6ba0b6cbda5749d4bf00e63ee89,exchangelib/util.py,0,39,121,153,274
sissaschool/xmlschema,34a06cc4b5a95b20b7e423d29ccf41a74f804989,xmlschema/validators/identities.py,0,6,39,24,63
sissaschool/xmlschema,1108dd6fcf03d3140f5366365f760c9d7e9e2f5a,xmlschema/validators/identities.py,4,7,134,152,286
pytroll/satpy,ea063f8804d31235ccfe927eca4a871a09ddb572,satpy/readers/fci_l2_nc.py,0,1,1,2,3
pytroll/satpy,6d888bea044fa063e00b90bc80c4aab8e29f7004,satpy/readers/fci_l2_nc.py,0,7,13,14,27
SimpleITK/SimpleITK,9e472d57e043a782ba33ee838373c96a736c9a1a,Examples/Python/SimpleGaussianProcedural.py,0,1,1,1,2
pauliacomi/pyGAPS,c6c13bb70ec43c52477d7ea990e50f79e41dd6ee,src/pygaps/core/modelisotherm.py,0,2,27,12,39
litex-hub/litex-boards,99a66274c85f4ad638f10ffe0012c3dce0361a48,litex_boards/targets/xilinx_alveo_u280.py,0,3,114,7,121
rackerlabs/django-DefectDojo,b15ff1813f2365a5356922922f94a15d1eafb605,dojo/tools/scout_suite/parser.py,0,9,32,70,102
rocky/python3-trepan,165213ca5c39e822379abb92b5c4f0df8769535b,trepan/processor/command/unalias.py,0,2,19,20,39
matrix-org/synapse,800ba87cc881856adae19ec40485578356398639,synapse/replication/tcp/client.py,0,1,1,1,2
lowRISC/opentitan,e43844a824118536c4e98241eb6954fc25106c98,util/regtool.py,0,2,1,7,8
wagtail/wagtail,815cb6e405c0671db829279ed418c4a0ed21bbbf,wagtail/contrib/forms/views.py,22,1,113,272,385
wagtail/wagtail,d10f15e55806c6944827d801cd9c2d53f5da4186,wagtail/contrib/forms/views.py,0,12,95,106,201
frappe/erpnext,494bd9ef78313436f0424b918f200dab8fc7c20b,erpnext/maintenance/doctype/maintenance_schedule/maintenance_schedule.py,0,12,97,146,243
Kozea/WeasyPrint,c56b96b3c1c467d0b75f6059682138ab1ace97f3,weasyprint/document.py,0,4,5,6,11
Kozea/WeasyPrint,a9a24f754f136e786d756a047514b9ceb3b948c7,weasyprint/document.py,0,4,5,11,16
Kozea/WeasyPrint,9b4150c406e45fde9f0dd1832409b368f521f9a4,weasyprint/document.py,0,9,250,13,263
Kozea/WeasyPrint,09364c254ea208f602a6d42c546c502743c97e88,weasyprint/document.py,0,3,612,14,626
frappe/erpnext,494bd9ef78313436f0424b918f200dab8fc7c20b,erpnext/accounts/doctype/shipping_rule/shipping_rule.py,0,7,28,51,79
ray-project/ray,7f1bacc7dc9caf6d0ec042e39499bbf1d9a7d065,python/ray/_private/parameter.py,0,11,87,105,192
automl/auto-sklearn,be2dfaf10d6cae138931134cde398b114d1cdcec,autosklearn/metalearning/metalearning/meta_base.py,0,5,10,17,27
conan-io/conan,ae6634347b491be3b566987b3c882c8cf7744df7,conan/tools/microsoft/subsystems.py,1,1,171,5,176
fabioz/PyDev.Debugger,51f4ae23c75dfac83d8d22a6a197a94f126a92d2,_pydev_runfiles/pydev_runfiles_xml_rpc.py,0,14,44,18,62
Maselkov/GW2Bot,da0c4dc4213bade7f5f7c277ce718319f4a0901b,guildwars2/evtc.py,9,13,242,220,462
GoogleCloudPlatform/gcpdiag,5062aaec014f2f43cb426955960f1c8dee553d9a,gcpdiag/queries/gce_stub.py,0,4,68,19,87
lowRISC/opentitan,ef51081c8a8e39519287b17c1fadb2edd4c7b141,hw/ip/otbn/dv/otbnsim/sim/sim.py,5,4,50,76,126
adbar/htmldate,a2ddbf5db6cc7d1615868637e9400d1aca369b3e,htmldate/extractors.py,0,7,79,106,185
adbar/htmldate,a03d0c49b9fc62e9faa3379ccc5f08717c5e79b7,htmldate/extractors.py,0,8,63,64,127
adbar/htmldate,7aee7b6fb9cef73663fbb327e92d436f88f708af,htmldate/extractors.py,0,8,29,21,50
spesmilo/electrum,dd6cb2caf7e1eff6a8af07a2e0363da371aa1b13,electrum/gui/qt/main_window.py,3,21,454,76,530
spesmilo/electrum,2d68350900dedd14f0a235461b1e0a22b96a6981,electrum/gui/qt/main_window.py,0,23,730,23,753
google/weather-tools,eb95533dec135d9637bc95afe09ce38b2661cf4a,weather_mv/loader_pipeline/pipeline.py,1,4,328,29,357
czcorpus/kontext,16f3f5a8b4084342d503abf58da19a427bb86325,public/app.py,0,3,58,3,61
isard-vdi/isard,5075b0825ba34972f87ca7b1f576a7eff37a4117,api/src/api/libv2/isardVpn.py,0,6,8,19,27
PyCQA/pylint,96d7e898cc863a6854cd0870ba4069c8f7d7851b,pylint/checkers/format.py,0,2,13,10,23
radiasoft/sirepo,c12e6b387f28356e91aa9338389dfb7325dfdc24,sirepo/template/radia.py,8,16,516,315,831
MIT-LCP/wfdb-python,184f4fb28c063a7fdad5022c87c02e5681680c88,wfdb/io/_signal.py,0,2,19,16,35
quantumlib/qsim,c44a31089cffa818561499796f0c7069acf84cd4,qsimcirq/qsim_circuit.py,25,11,112,142,254
quantumlib/Cirq,2d2226a8517bcf58a9caaa5fe19bb4ec36e7c78b,cirq-core/cirq/devices/noise_properties.py,3,2,249,107,356
ArtifexSoftware/mupdf,688aa9d70c7ecfad3ea96d1a3160986da3a08c70,scripts/mupdfwrap.py,0,1,10463,3,10466
spesmilo/electrum,649cad0122c877307948d322652955df9f9f1b90,electrum/gui/qt/paytoedit.py,6,9,38,59,97
spesmilo/electrum,ed1567e841935acc4e07edc050fd9cfd9a71f0aa,electrum/gui/qt/paytoedit.py,0,8,23,6,29
Maselkov/GW2Bot,da0c4dc4213bade7f5f7c277ce718319f4a0901b,guildwars2/notifiers.py,3,4,299,250,549
DemocracyClub/UK-Polling-Stations,a7e50b1c2a71e458e669f219894f4c96c1296046,polling_stations/apps/data_importers/management/commands/import_ryedale.py,1,1,50,23,73
fabioz/Pydev,89c9e747e052957de792eef2127b6574db1aa2be,plugins/org.python.pydev.core/pysrc/_pydev_runfiles/pydev_runfiles_xml_rpc.py,0,14,44,18,62
lowRISC/opentitan,97ed2b229b8dbb7a2d73adf66079ae938f6f1b78,hw/ip/otbn/dv/otbnsim/sim/state.py,0,5,40,49,89
OstapHEP/ostap,06f26cd0ab2c7ccda020f7ce8beb3dbfad781e52,ostap/fitting/fit2d.py,10,27,1418,246,1664
google/capirca,73b210a6d4f08680af97e67795d4bfef984a4059,capirca/lib/nftables.py,18,2,309,726,1035
OstapHEP/ostap,06f26cd0ab2c7ccda020f7ce8beb3dbfad781e52,ostap/fitting/fit3d.py,11,47,1758,533,2291
wikimedia/pywikibot-core,402beea5ac23ab9d7263f71cbfa5da93ad7b9033,pywikibot/userinterfaces/transliteration.py,0,3,85,81,166
mikf/gallery-dl,04bed1eba3cda9b67aea5159a7bcda920d9b1159,gallery_dl/formatter.py,0,0,0,0,0
google/report2bq,f5245cea6111a647d6268e376cfb88b0e3252db9,application/classes/scheduler.py,2,16,95,102,197
p1c2u/openapi-core,9837b8699e44afe15f3d869a0616bcefb2477d42,openapi_core/validation/request/validators.py,0,7,37,65,102
desihub/desispec,aa01021cefda7a1caa937209ad73b8a4a1671443,py/desispec/util.py,0,2,3,4,7
desihub/desispec,8d66b1976089d30b5fe82da76088153bfd1c2afa,py/desispec/util.py,0,2,8,12,20
spesmilo/electrum,c463f5e23daff71f05486f53ab04510d538dbec7,electrum/daemon.py,4,6,3,91,94
beautify-web/js-beautify,92f3639da40e3fe08df4a9456e88f2156d3a9b53,python/jsbeautifier/javascript/beautifier.py,1,0,0,0,0
beautify-web/js-beautify,9cceee0d7432429851c9470ef13ad284df0d99d3,python/jsbeautifier/javascript/beautifier.py,0,2,7,9,16
beautify-web/js-beautify,73e57eef862219edcfc18b1956f285d407f3d52d,python/jsbeautifier/javascript/beautifier.py,0,2,7,9,16
beautify-web/js-beautify,11f2dae290f8c659718b2ed2a5bc376cc2926976,python/jsbeautifier/javascript/beautifier.py,0,3,0,7,7
beautify-web/js-beautify,c90470061c775a42b9c7a99840d2a5d436a89407,python/jsbeautifier/javascript/beautifier.py,0,3,12,2,14
beautify-web/js-beautify,6d032d373971bd68b1df88932690239f7cd5b123,python/jsbeautifier/javascript/beautifier.py,0,3,12,2,14
openstack/neutron,e6d27be4747eb4573dcc5c0e1e7ac7550d20f951,neutron/plugins/ml2/drivers/ovn/mech_driver/ovsdb/ovsdb_monitor.py,18,6,187,103,290
Maselkov/GW2Bot,da0c4dc4213bade7f5f7c277ce718319f4a0901b,guildwars2/worldsync.py,1,5,50,53,103
cupy/cupy,321bd9ac10c310adf0af85760407437f67aa1d45,cupy/array_api/_array_object.py,0,7,93,119,212
isard-vdi/isard,5075b0825ba34972f87ca7b1f576a7eff37a4117,api/src/api/views/HypervisorsView.py,0,10,198,44,242
engineervix/Bible-Playlist-Generator,678a2339d0a0dd0838a560e3043a7d59fc173d49,tenlists/cli/__main__.py,0,13,12,4,16
tensorflow/docs,3a6a7a3322de8620f0031ae3a0a4b62e40d1d7f2,tools/tensorflow_docs/api_generator/public_api.py,11,2,48,179,227
Wintermute0110/plugin.program.advanced.emulator.launcher,07e900756b13af8efa74dd5a6126e48bfce07257,resources/assets.py,1,13,291,210,501
Giswater/giswater_qgis_plugin,3d45fda9939a7cdf7adaccfb4276020e1e989024,core/shared/search.py,0,3,32,2,34
metabrainz/listenbrainz-server,839e62121b4ec6e1dec9c3a0fec824c358e5765d,listenbrainz/db/dump.py,1,4,13,30,43
corpnewt/CorpBot.py,a63ceed25c4a5f4b06585a5229a241b9038e51ee,Cogs/Music.py,12,10,793,921,1714
jumpserver/jumpserver,e259d2a9e9167c58fa75a78d1050dd5dcfde96f4,apps/orgs/middleware.py,0,2,13,11,24
Azure/WALinuxAgent,c7fd71254ad39c5c10f13a653ffa7d3de1120f2e,azurelinuxagent/ga/update.py,0,2,5,0,5
Azure/WALinuxAgent,37a014b277a79341c363800d86405ab599240d7d,azurelinuxagent/ga/update.py,0,17,650,29,679
sqall01/alertR,99284bf65de50db3f628b3835c219cda90b2bd47,sensorClientExecuter/lib/sensor/executer.py,0,4,165,7,172
apache/airflow,47801057989046dfcf7b424ce54afee103803815,airflow/models/baseoperator.py,0,22,26,57,83
apache/airflow,46a337c8cda6fcc515fffe9a4e4cc324edaefa0a,airflow/models/baseoperator.py,0,2,101,9,110
globocom/database-as-a-service,ec4f54765bcaaf20011ea2ca2527a087e49fd6f8,dbaas/maintenance/models.py,0,1,2,12,14
globocom/database-as-a-service,9d903e08588c678e10abb6f5d0b473fdc85d3aa7,dbaas/maintenance/models.py,1,2,26,5,31
WeblateOrg/weblate,ffd9a3898666ac3fd544513b6efe4c27e36b8d71,weblate/trans/views/edit.py,0,0,0,0,0
WeblateOrg/weblate,38298810d9570b40e8840f948a9d54b3dc8ddb10,weblate/trans/views/edit.py,0,3,46,5,51
WeblateOrg/weblate,41712c88f485132cf2a416dcca29fd9b90b97310,weblate/trans/views/edit.py,1,2,42,43,85
WeblateOrg/weblate,1226c5db251da4dc3d2d92ca5128ade6ab33c0fb,weblate/trans/views/edit.py,0,1,3,0,3
analyst-collective/dbt,bda70c988e34a29566ad45e98e210119d3b351d6,core/dbt/config/renderer.py,0,3,66,2,68
espressif/esptool,4875e8906fdedeb7ecb2f94aa40877c418df3b70,esptool.py,0,1,5378,5,5383
isard-vdi/isard,5075b0825ba34972f87ca7b1f576a7eff37a4117,api/src/api/views/DesktopsNonPersistentView.py,0,2,200,18,218
DStauffman/dstauffman,5344f6ed74637d17ef9a9bdd74410eca671cb376,dstauffman/utils.py,0,12,17,17,34
p1c2u/openapi-core,9837b8699e44afe15f3d869a0616bcefb2477d42,openapi_core/validation/response/validators.py,0,7,38,58,96
tensorflow/tensorflow,6c95675492aa8d25619f5e4ce1674582c051a7fe,tensorflow/python/framework/ops.py,0,4,32,37,69
tensorflow/tensorflow,b93741e530ec56cf556422432c2cd226861ea86e,tensorflow/python/framework/ops.py,0,3,31,6,37
specify/specify7,7bf4143f77099a8e04e3740979432e766f984d5c,specifyweb/stored_queries/format.py,1,3,10,17,27
specify/specify7,95dba7ff4abc0cba1197dacc30623d76e791ae36,specifyweb/stored_queries/format.py,0,2,18,0,18
BruceDLong/CodeDog,15918cf8360e850106b84f51c2dc1d44983ec300,xlator_Java.py,2,21,368,308,676
Catch-up-TV-and-More/plugin.video.catchuptvandmore,5e1ca6eb7afe06ccc1a17cf2c7f5cec495a9a391,resources/lib/channels/fr/mycanal.py,0,0,0,0,0
Catch-up-TV-and-More/plugin.video.catchuptvandmore,d9640788dbf497efa5340f0e9aa2d48f4d3634ee,resources/lib/channels/fr/mycanal.py,1,10,61,52,113
spulec/moto,67ab7f857ac87671578ebb1127ec971d030ec43a,moto/xray/responses.py,0,3,6,3,9
ntop/nDPI,beef4f997bccc90c545abdf8d387bab600b4af8f,python/ndpi_example.py,6,1,252,144,396
merenlab/anvio,c2d569d7afde14f336dc2fc571dc57b9b5eeed8a,anvio/genomesimilarity.py,0,1,42,18,60
zynthian/zynthian-ui,0364e4afca7596559faa1f50c881d7efe0d159fb,zyngui/zynthian_gui_mixer.py,59,10,670,864,1534
catapult-project/catapult,3a12d6ccdec28da8bda09d9ff826aae1f9504e59,third_party/gsutil/gslib/vendored/boto/boto/auth.py,1,3,24,22,46
PanDAWMS/panda-jedi,4f6eeefc320a8dc6a069daedee52627e3adb9137,pandajedi/jedithrottle/AtlasProdJobThrottler.py,0,1,414,3,417
bobintetley/asm3,4079245adbeb98296ce5a660305e7cb52fee8fe9,src/asm3/publishers/savourlife.py,0,11,18,16,34
sshuttle/sshuttle,5719d424de732d218ade4670fd0d987b8aad2736,sshuttle/cmdline.py,0,2,15,3,18
osm-fr/osmose-frontend,7b69934c3c6156456d8b44809f961b53e82e42cd,api/issues_tiles.py,0,8,37,50,87
all-of-us/raw-data-repository,81ab600075a86ea414ac3ba9d2e8ffaefe96e4b9,rdr_service/dao/genomics_dao.py,2,5,72,15,87
rdmorganiser/rdmo,d957260fefbde1c6dfbc2ce3f91ce0e02dc66646,rdmo/services/providers.py,35,10,222,72,294
stb-tester/stbt-rig,37a41eb4ab1d8da247302da7c1df162c6fe465d0,stbt_rig.py,2,3,28,49,77
tensorflow/tfx,4fe77a96fd7be685308180ed226515ad9d2e8849,tfx/dsl/compiler/compiler.py,16,12,402,761,1163
ToFuProject/tofu,7543d4a44c6d76e539e1a9f3e13d84a229da538e,tofu/imas2tofu/_core.py,0,3,254,39,293
ToFuProject/tofu,81bc3e90ad77c34467565da6c1265740f2ca4e2c,tofu/imas2tofu/_core.py,0,7,301,107,408
PhasesResearchLab/ESPEI,b9bc9feb9632a7df58abf6897cf685b0122ad131,espei/paramselect.py,2,11,17,41,58
openstack/ceilometer,318c54648c2c85d4f4f5425c5ffc5e5f3dda86f2,ceilometer/neutron_client.py,0,3,334,0,334
Oinosseus/acswui,a9649e674184646588079905195528b7b0431043,pyacswui/command_install.py,0,18,626,92,718
DiCarloLab-Delft/PycQED_py3,f41d7785ea96c68e2b400ee791f8d93bd8b571cf,pycqed/instrument_drivers/meta_instrument/HAL_Device.py,50,0,0,0,0
Catch-up-TV-and-More/plugin.video.catchuptvandmore,5e1ca6eb7afe06ccc1a17cf2c7f5cec495a9a391,resources/lib/channels/be/rtbf.py,0,0,0,0,0
Catch-up-TV-and-More/plugin.video.catchuptvandmore,78d9b61e3ee6e309b70a4db576b7d4ca9f6df4de,resources/lib/channels/be/rtbf.py,0,2,31,36,67
Catch-up-TV-and-More/plugin.video.catchuptvandmore,3582fd992c3abf8a8d075d7b1cfc80fee8011c14,resources/lib/channels/be/rtbf.py,1,24,102,102,204
matrix-org/sydent,029dbd01e01ea7bbc0e9b38ae5ef970d99c7f080,scripts/casefold_db.py,0,3,24,20,44
dedupeio/dedupe,4a12ea88603eafe6b35e6188ca261e5ae01bf43b,dedupe/datamodel.py,0,1,10,7,17
pcolmant/repanier,11ca59304d02b28828b6adc0a63faa93d0118459,repanier/models/invoice.py,0,2,108,68,176
regardscitoyens/nosdeputes.fr,1ad65de92fdf08ed3a17cfc4e0ba99cf20225d93,batch/commission/parse_commission.py,1,2,33,44,77
Giswater/giswater_qgis_plugin,25febf2b9c25881a7cd4710c9b5a386f36abb03c,core/threads/project_layers_config.py,0,1,45,26,71
python-poetry/poetry-core,dd96ae7ae7eb2f8ddbaf39fc3b5f0a3141b13281,src/poetry/core/packages/dependency.py,0,2,33,5,38
frappe/erpnext,3dadfc9048d804e097ebfe6801802f2c980e04a7,erpnext/accounts/report/profitability_analysis/profitability_analysis.py,0,2,14,0,14
mrachinskiy/jewelcraft,732ed407b2bbdbc7d7218d5d142bc520d3d95cba,ops_object/curve_ops.py,0,1,21,18,39
angr/angr,46e37e88f4d2eea0ba77e7e9429b90497eae53b5,angr/exploration_techniques/tracer.py,0,1,14,13,27
pymedusa/Medusa,6da7bfa9017fe726add1c5ce1450adfa0ac58335,ext/knowit/utils.py,4,1,40,79,119
ccxt/ccxt,5743e7407bce18310f50638ea59b124656d361a2,python/ccxt/bitget.py,5,22,1636,1113,2749
cobbler/cobbler,d09e27227b73494b718450d09ea796f73f14f51a,cobbler/cli.py,1,19,103,112,215
CalebBell/fluids,4473adbcab7aa770a8bd14a31464d949292f0a50,fluids/numba.py,1,4,33,39,72
pcolmant/repanier,5dc8882764d50b8f7d3650d848cb746a54297942,repanier/views/order_select_ajax.py,0,0,0,0,0
pcolmant/repanier,127d5ecd3f6620309cbae5c7f34669c265c19ab3,repanier/views/order_select_ajax.py,0,4,110,100,210
unioslo/cerebrum,9778e89210e87a4427fac700f5083b157c84f864,Cerebrum/modules/no/hiof/bofhd_hiof_emailcmds.py,0,0,0,0,0
MarxMustermann/OfMiceAndMechs,d5a462e579b46af9669519b147d52fb009621648,src/itemFolder/manager/cityBuilder2.py,0,3,148,3,151
DStauffman/dstauffman,5344f6ed74637d17ef9a9bdd74410eca671cb376,dstauffman/aerospace/classes.py,0,8,6,9,15
pnwairfire/bluesky,2f72bd8536bb7135e0edfa1af9d647b1c1ab4701,bluesky/dispersers/hysplit/hysplit.py,1,2,27,65,92
arsenetar/dupeguru,efd500ecc1eb604918da3fc01512c502912771d8,core/directories.py,0,1,41,39,80
openatv/enigma2,4ce039826d047f89ee6af256d26bef85a4ef3762,lib/python/Components/About.py,0,0,0,0,0
openatv/enigma2,9615cb36455fff632b389b4ed11dc7457fdb9a10,lib/python/Components/About.py,0,0,0,0,0
openatv/enigma2,32a09d76de24c321e43ca2cbcfaca5d7c5762124,lib/python/Components/About.py,0,0,0,0,0
castlecms/castle.cms,2c5a7417ceb7b87162c0146563b3dc39378ba883,castle/cms/cron/_crawler.py,0,10,189,91,280
opendatadurban/scoda,a115dfab86e3ef4e1fadfb50c624448f5555cd62,scoda/public.py,0,1,261,0,261
nextgis/nextgisweb,ca5f4b6b985664df01798db735e7dc92d68ec9f4,nextgisweb/resource/model.py,0,0,0,0,0
nextgis/nextgisweb,d2325206b75d159df8074ae2b2639080488f075f,nextgisweb/resource/model.py,0,1,21,15,36
JamesJeffryes/MINE-Database,6aee38c72e4497b90dbc8c1185940402bd9d5099,minedatabase/utils.py,0,2,34,6,40
kobotoolbox/formpack,e529d316d17138138ce3f63e44eb56d898f9437f,src/formpack/reporting/export.py,0,3,91,16,107
kobotoolbox/formpack,5680c70616f0c70659d3a8351df090224d29b932,src/formpack/reporting/export.py,0,8,31,8,39
kobotoolbox/formpack,d2fa2de630f085b497cb0fd2c494b672d226db1c,src/formpack/reporting/export.py,0,2,17,10,27
openstack/tacker,78dbba65c755b4d63a8a3a5614b7fff6bb5f1b0d,tacker/sol_refactored/infra_drivers/openstack/userdata_utils.py,0,2,222,0,222
pantsbuild/pex,a126114ce3f6fb3a9c0bf2ee9c448ffe3619e13d,pex/tools/commands/venv.py,4,5,436,76,512
unioslo/cerebrum,b1f5c3ea35f7bd4083700b0b0b574879e30f5838,Cerebrum/modules/no/uio/bofhd_uio_cmds.py,0,0,0,0,0
unioslo/cerebrum,2e5c9988af0ff90659f9ae79e21e51cbf5d8766b,Cerebrum/modules/no/uio/bofhd_uio_cmds.py,0,0,0,0,0
angr/angr,aa173564a1f5252439de0078942f9235e2e61c1a,angr/analyses/decompiler/region_simplifiers/expr_folding.py,0,2,7,7,14
pypa/pip,373fca928e012413f502ffc911b8746af24532a6,src/pip/_vendor/rich/_inspect.py,4,6,18,66,84
reanahub/reana-client,98f2e6ba90135a15b770b0f5322dff78763fa2fb,reana_client/cli/files.py,0,2,26,45,71
apache/airflow,0cd3b11f3a5c406fbbd4433d8e44d326086db634,airflow/models/base.py,0,2,128,1,129
OstapHEP/ostap,80375abdb7d30d46f1f440e5d3d88cda6686304e,ostap/tools/tmva.py,0,5,63,69,132
moodpulse/l2,6d488f6f189351814391143fbf629a307987341c,receivematerial/views.py,0,2,130,1,131
lilydjwg/nvchecker,3e88d740430b8052bb03c3a3387cf63094a6b93b,nvchecker/tools.py,0,3,18,44,62
lilydjwg/nvchecker,ea01b6d9eed9c91f1c9b15a7605bbc6815a76d99,nvchecker/tools.py,0,3,19,58,77
spulec/moto,06ed639a4f3142d0c47ddbd9fcdab68b6ded7e2b,moto/core/responses.py,0,1,63,0,63
hasgeek/funnel,0997d1fa925badac879b312fbcf68d06db469caa,funnel/views/video.py,0,2,24,22,46
CompassionCH/compassion-modules,7048255ba5bb2c85d972c656e2b033211d3541e0,sbc_compassion/models/import_letters_history.py,0,5,44,44,88
CompassionCH/compassion-modules,f5057eef67be24c0b30700844b90aba1d736ce40,sbc_compassion/models/import_letters_history.py,3,5,127,70,197
OCA/account-financial-reporting,7cf6d542abc3430d61a61903a49d5665ae79d7f9,account_financial_report/report/trial_balance_xlsx.py,0,2,10,2,12
ccxt/ccxt,5743e7407bce18310f50638ea59b124656d361a2,python/ccxt/async_support/bitget.py,5,22,1636,1113,2749
craws/OpenAtlas,94d3bcbbbd3c97d16e968e5db3ebda69ed23b586,openatlas/views/hierarchy.py,0,5,18,18,36
rockcesar/odoo_addons,7c0fb11525f1990dcd1275a2f314986d1b91b44c,website_pinetwork_odoo/models/admin_apps.py,0,1,1,1,2
rockcesar/odoo_addons,ebcf143c076a09a5fed85312b1354d91afa9cc68,website_pinetwork_odoo/models/admin_apps.py,0,3,10,9,19
rockcesar/odoo_addons,4d9e9ea732d66012bab3287c7f8ebd5fafc1ac4c,website_pinetwork_odoo/models/admin_apps.py,0,2,0,2,2
alisaifee/flask-limiter,130bee518182ee2c2a00a62f3dee44a5c82050d7,flask_limiter/extension.py,1,11,63,173,236
ray-project/ray,d7ef546352c78f5080938a41432b8de4c0c81ff0,python/ray/actor.py,1,17,238,106,344
lowRISC/opentitan,f2396eb50beb23907a05b7a9d4e003203fb5728d,util/make_new_dif.py,0,3,14,16,30
wikimedia/pywikibot-core,50b1951fe1496483879ba890b123001fdae9e938,pywikibot/logentries.py,0,1,7,13,20
hasgeek/funnel,6997b117c9a09fdefa03c92117138c6a8c44751a,funnel/views/helpers.py,0,6,26,13,39
janeczku/calibre-web,dad251d02c48b3f4cc2cddca473e208691019e6c,cps/web.py,1,44,52,506,558
janeczku/calibre-web,29462e2278450253cacd3ac2735d1cd650c3f21b,cps/web.py,1,2,0,8,8
janeczku/calibre-web,e7464f26948bc6695b99de5420fc035e5ba6b12b,cps/web.py,0,7,382,14,396
Giswater/giswater_qgis_plugin,143a91f20ca7ac34603674feb79dfeab604c88eb,core/threads/epa_file_manager.py,0,1,3,16,19
mwaskom/seaborn,de1ecf0e0d0064982ebf4f13e1b1afddd27c80ff,seaborn/categorical.py,0,2,14,3,17
openstack/cinder,372b6fb8119c9f1e1b92a87461dca361aba4f80c,cinder/volume/drivers/dell_emc/powermax/common.py,0,7,14,20,34
openstack/cinder,e1f6de6f836e1d534d0196ba43e6642bc5e279c6,cinder/volume/drivers/dell_emc/powermax/common.py,3,16,47,119,166
openstack/cinder,9a8583b2ef59f6a392b8b1a1efef8d3d270cf9ea,cinder/volume/drivers/dell_emc/powermax/common.py,3,16,47,119,166
openstack/cinder,a41cf9e726529581671a19539203e4bb74a306c8,cinder/volume/drivers/dell_emc/powermax/common.py,5,47,138,369,507
hail-is/hail,e657e712d6dd295805743dc5fca0d006ac150922,auth/auth/driver/driver.py,0,2,5,5,10
kizniche/Mycodo,c7a106d1591315c688b837fd43704c16f9d3cb39,mycodo/mycodo_flask/routes_general.py,0,1,3,2,5
GoogleCloudPlatform/cloud-data-quality,f09ef600b24e6efef9f8d7b201c017625b12c8a2,clouddq/main.py,0,9,64,19,83
rocky/python-uncompyle6,c8550d5c9e8220ff3dc568d521f78e8fc4a3fae1,uncompyle6/semantics/pysource.py,0,4,69,3,72
rocky/python-uncompyle6,e2ff9096031ea50fb0fc3a6f3a56c179fbd4ac3b,uncompyle6/semantics/pysource.py,0,6,847,2,849
edgedb/edgedb,fabd4370fbcd273cc5ca5ee5aaababd5242cb715,edb/pgsql/compiler/clauses.py,0,2,65,1,66
MarxMustermann/OfMiceAndMechs,19cf8693c83856535be89488ecf6a8813c64c304,src/overlays.py,0,2,45,183,228
locustio/locust,dc4a27d69431197ea2e15c59d5c70d08373428e1,locust/stats.py,5,47,132,175,307
learningequality/kolibri,448b971b856b25c9e97842149e3726fe5c6ae81f,kolibri/core/content/utils/import_export_content.py,0,0,0,0,0
BruceDLong/CodeDog,15918cf8360e850106b84f51c2dc1d44983ec300,xlator_CPP.py,2,28,444,265,709
sqall01/alertR,6d4184756e6c612f809b5dbd311ce758aa29aae3,server/lib/localObjects.py,0,2,329,2,331
MarxMustermann/OfMiceAndMechs,8a8b8b7bf444e0249f3e35eedc1769efaa0afcbe,src/rooms.py,0,9,38,39,77
openego/eDisGo,6f5d5dece1e884ce8a3f260dd68f9dfb4278618e,edisgo/network/results.py,0,13,14,14,28
openego/eDisGo,10509ef5a2d3653804c3d77a4d68115d15b3b4cb,edisgo/network/results.py,0,13,14,14,28
couchbase/couchbase-python-client,6d305796b094024c2ea07c8c963899999420f610,couchbase/result.py,70,1,575,456,1031
corpnewt/CorpBot.py,7f328ea2ef7e86302e5b61a4f7bc789f01eabaff,Cogs/Debugging.py,0,2,5,6,11
corpnewt/CorpBot.py,f4ac72cbffb4745efdf67f7a608fca306851c9f2,Cogs/Debugging.py,0,17,22,18,40
couchbase/couchbase-python-client,6d305796b094024c2ea07c8c963899999420f610,txcouchbase/cluster.py,22,1,592,243,835
fja05680/pinkfish,368d7aeed22a82150b36a230aeb90f3559f630f4,pinkfish/portfolio.py,0,13,26,25,51
dlatk/dlatk,990ca3d4b8c4f13914cd14e7001a6f9fab137a02,dlatk/classifyPredictor.py,0,64,986,1611,2597
dlatk/dlatk,c4aed1460ac4deaa8881fdea99501d4b73aac3b8,dlatk/classifyPredictor.py,0,1,4,1,5
mmgen/mmgen,f1844789d774092f8670edadc6c1b437623c0f91,mmgen/rpc.py,0,4,398,14,412
xupingmao/xnote,cc1502a1f835abd2533dafca0eaf9c82ae6c610a,handlers/system/system_log.py,0,8,34,37,71
conda-forge/conda-forge-webservices,f75ce399d51626d12e0509d61da85727afd7aee3,conda_forge_webservices/webapp.py,0,2,66,35,101
conda-forge/conda-forge-webservices,2e405dcf88663b9a48676d45393f69ff3637bf9a,conda_forge_webservices/webapp.py,0,1,37,37,74
conda-forge/conda-forge-webservices,0ad4b14163f567de3a73b69f8116e49078228b96,conda_forge_webservices/webapp.py,0,1,1,1,2
gingerBill/Odin,7e8b9862b9049f6ca1300c34857244828fae1102,vendor/vulkan/_gen/create_vulkan_odin_wrapper.py,0,7,27,112,139
moodpulse/l2,4324e71f86f669d89fd973004c4c02c3a825e348,directions/views.py,0,3,331,0,331
sqlalchemy/sqlalchemy,a4bb502cf95ea3523e4d383c4377e50f402d7d52,lib/sqlalchemy/dialects/postgresql/psycopg.py,2,2,2,2,4
walles/px,4bb7f25b0ba3bfce592fc27ab6ce56bbbe11a2cf,px/px_loginhistory.py,0,1,2,1,3
DStauffman/dstauffman,5344f6ed74637d17ef9a9bdd74410eca671cb376,dstauffman/utils_log.py,0,4,8,8,16
FDio/vpp,d9b0c6fbf7aa5bd9af84264105b39c82028a4a29,src/plugins/map/examples/gen-rules.py,0,8,41,119,160
openstack/os-brick,9bc671df38438f2df3887af5fa0b2fef35e7a839,os_brick/initiator/linuxfc.py,0,3,16,5,21
openstack/os-brick,c5076c37cb674dd0aa2102b6b2721cc4b22ca898,os_brick/initiator/linuxfc.py,0,5,69,17,86
pandas-dev/pandas,cf2dfa76d2736af151e429843be986884e1e74e4,pandas/core/arrays/integer.py,5,6,55,16,71
gbrammer/grizli,87ea6101ea152c3760792aafe8d7410ddcfbf970,grizli/utils.py,0,5,11,99,110
sqlalchemy/sqlalchemy,fd4ac5b3171dacf2efba31c520c546e2422fba36,lib/sqlalchemy/sql/expression.py,1,5,27,25,52
sqlalchemy/sqlalchemy,5a6a475e14f09a36061b7422534b073e1041fe44,lib/sqlalchemy/sql/expression.py,0,2,9,6,15
amccaugh/phidl,721460a7c4a6a7aa71c99f6fb5c28cc8e4a88f40,phidl/quickplotter.py,0,22,253,361,614
pandas-dev/pandas,bcf2406dc49e47ced45eca2e2fef0ed42fa900cf,pandas/core/internals/concat.py,1,9,118,44,162
pandas-dev/pandas,d43d6e27d1af0b07df495e113e9818fc2f1909b1,pandas/core/internals/concat.py,3,17,133,245,378
DStauffman/dstauffman,5344f6ed74637d17ef9a9bdd74410eca671cb376,dstauffman/plotting/plotting.py,0,10,11,11,22
SuperDARNCanada/borealis,557f73756e4444824443867a52aa471a954b7c44,scheduler/local_scd_server.py,0,10,80,80,160
facebookresearch/faiss,b8fe92dfee9ea6f9c8cae27e4fc3ffeb12b5c4d2,benchs/distributed_ondisk/distributed_kmeans.py,0,3,186,15,201
DStauffman/dstauffman,5344f6ed74637d17ef9a9bdd74410eca671cb376,dstauffman/time.py,0,2,6,2,8
psi4/psi4,35b24baca552b95b311f2349806de0aa38f4333b,psi4/driver/diatomic.py,0,1,1,1,2
fja05680/pinkfish,b875daec838d5101f01b57872a0d22c13ed1e6e3,examples/175.compare-strategies/golden_cross.py,0,4,10,3,13
PyCQA/pylint,9d46885ab0dba902ce6a0aecfbec90bcbef1bee7,pylint/checkers/design_analysis.py,0,3,1,8,9
dask/dask,e50593212bb541520d035b5953760bad1ed9b98f,dask/dataframe/io/parquet/arrow.py,0,5,14,13,27
google/glazier,86cf41fd1208ad14d1affad02c74beb33910d864,glazier/lib/config/builder.py,0,1,2,0,2
radiasoft/pykern,9551826282bb90d1a4d73219af726637da75665c,pykern/pkconfig.py,0,29,95,108,203
spesmilo/electrum,3f3212e94d01a6c2f2bbdcf488eb81518f208e3e,electrum/exchange_rate.py,0,1,3,0,3
zynthian/zynthian-ui,0364e4afca7596559faa1f50c881d7efe0d159fb,zyngui/zynthian_gui_midi_profile.py,0,2,2,2,4
voussoir/etiquette,85055cdea257c2a711a7dbfbf7c857268901bd6d,frontends/etiquette_cli.py,0,3,489,987,1476
Neutree/COMTool,c816ded77e719477366f77dfd1f001907a96e48e,COMTool/Main.py,1,5,3,17,20
kdeldycke/meta-package-manager,426e6f9c71f8ed4e423d254ed5644d1db07e5ec2,meta_package_manager/base.py,0,2,5,2,7
kdeldycke/meta-package-manager,ee626809ce8d9c9d324c92cf6f28920bdc70f717,meta_package_manager/base.py,0,6,7,12,19
python-attrs/attrs,980c8b04f59d93c429fc66d901d2a24c70a8d777,src/attr/validators.py,0,13,20,13,33
rdkit/rdkit,d8cf05cd252aa2e6b77b9f91e5b2500e3cefcc7c,rdkit/Chem/MolKey/MolKey.py,0,13,79,61,140
vilemnovak/blendercam,0e43b91c4d2ef215c62908bfecd610a600fdbbab,scripts/addons/cam/bridges.py,0,9,17,6,23
catapult-project/catapult,e999681ef89091d15a27b9dc74ae24b799db282a,dashboard/dashboard/pinpoint/models/quest/execution.py,0,2,1,4,5
QuantConnect/Lean,cece811cceb83d27fdd4dcb6a4bb696163880f41,Algorithm.Python/ETFConstituentUniverseMappedCompositeRegressionAlgorithm.py,0,1,1,1,2
xupingmao/xnote,e1f6160b468718cd33f68a1a86badc5b7d9ec1a3,handlers/note/note_group.py,0,0,0,0,0
xupingmao/xnote,33613bf383c07aa63c5cafc6b27183ef9a373bc5,handlers/note/note_group.py,0,32,296,301,597
RT-Thread/rt-thread,fcc4899b60844f30399da18408ee57fe6b130bfd,tools/iar.py,0,2,2,3,5
spesmilo/electrum,3f3212e94d01a6c2f2bbdcf488eb81518f208e3e,electrum/daemon.py,0,1,2,0,2
ligo-cbc/pycbc,11142c548ee91c37c8819a2f5e81b65f78eac873,pycbc/workflow/core.py,3,43,248,240,488
stack-of-tasks/eigenpy,e86d0a196e6410ad2c6b0843d396f040d7970cb0,benchmarks/bench-switch.py,0,2,2,3,5
zentralopensource/zentral,ca3d90ea73893b05fe3efc4bac7f51d25d271670,zentral/contrib/mdm/forms.py,0,1,1,0,1
zhmcclient/python-zhmcclient,20e6961ad2310d5eda1ef8581db4f7c7bd63bad3,examples/export_dpm_config.py,0,2,113,94,207
psychopy/psychopy,12dccb41c4136bc5dd36c77cc2c704b9f06f6a01,psychopy/app/_psychopyApp.py,0,0,0,0,0
psychopy/psychopy,2c2d80293874b121b0d2865d3fb85253ccb6df53,psychopy/app/_psychopyApp.py,0,0,0,0,0
psychopy/psychopy,0e05f2901ecb5dc223883db1f5b65bb8f7d2725f,psychopy/app/_psychopyApp.py,0,0,0,0,0
psychopy/psychopy,0666040304552a3757059f306a2ebe1f76206daf,psychopy/app/_psychopyApp.py,0,0,0,0,0
psychopy/psychopy,6f41a12c65ebbdfc25b1ae1cba4e2803abec0780,psychopy/app/_psychopyApp.py,0,0,0,0,0
jjjake/internetarchive,e9a319f7e6334ff766f1a9da5d18742b6f106e74,internetarchive/files.py,0,1,1,1,2
jjjake/internetarchive,a2335c897e6b250406c7216e613b5d179feab71e,internetarchive/files.py,0,10,34,23,57
zhmcclient/python-zhmcclient,20e6961ad2310d5eda1ef8581db4f7c7bd63bad3,examples/list_storage_groups.py,0,2,106,72,178
janeczku/calibre-web,41f89af9595afc8fe617cdca4f316bb32ccb615b,cps/gdriveutils.py,0,0,0,0,0
tlemoult/spectroDb,ff4f5d85390036b4fb8cdc3f4481e5d91dda2b61,telescope/indi/simpleAcquire.py,0,1,21,2,23
mupif/mupif,ec9cdef9b82d5e4fcf635aa3fa7023f3cb2c0e39,mupif/bbox.py,0,1,9,0,9
fja05680/pinkfish,b875daec838d5101f01b57872a0d22c13ed1e6e3,examples/150.scaling-in-out/strategy.py,0,4,6,4,10
edgedb/edgedb,5b4cc65f629ad0b69a158b901bf2d56eac9e67ab,edb/server/ha/stolon.py,1,7,18,21,39
SimpleITK/SimpleITK,9e472d57e043a782ba33ee838373c96a736c9a1a,Examples/SimpleIO/SimpleIO.py,0,2,19,20,39
SasView/sasview,e0b8de2b63c09ef22dde7b9f3575113ff36decc2,src/sas/qtgui/Perspectives/Corfunc/CorfuncPerspective.py,0,0,0,0,0
SasView/sasview,2d535fa2aeff8bfb8fe6881bb29bb203b12d77de,src/sas/qtgui/Perspectives/Corfunc/CorfuncPerspective.py,0,0,0,0,0
fja05680/pinkfish,b875daec838d5101f01b57872a0d22c13ed1e6e3,examples/160.merge-trades/strategy.py,0,4,9,6,15
Nitrate/Nitrate,4620d9521cf678ac010eed64de5ff7329a2bafdb,src/tcms/core/ajax.py,0,2,32,0,32
psychopy/psychopy,6d6d8e19998d4355ce13c1fb1157698d7894a1e9,psychopy/visual/basevisual.py,0,0,0,0,0
psychopy/psychopy,48816cc9af7913a1c9763aef1c85c529e857bee1,psychopy/visual/basevisual.py,0,0,0,0,0
psychopy/psychopy,2d74202c263a3673484872f600992fcb5a99be46,psychopy/visual/basevisual.py,0,0,0,0,0
psychopy/psychopy,3f828d4a071c457827430ca138af32838e4b6836,psychopy/visual/basevisual.py,0,0,0,0,0
psychopy/psychopy,919c59fd13aea17cd13d4f1f62236f2cce6ad496,psychopy/visual/basevisual.py,0,0,0,0,0
google/feedloader,446c050da87adfeeeef56d5f55f19d0be076cfe8,appengine/uploader/shoptimizer_client.py,0,7,10,24,34
diofant/diofant,8ab96042687f1d3e745e513d7e42038b8096f984,diofant/core/function.py,0,1,4,1,5
PyCQA/pylint,9d46885ab0dba902ce6a0aecfbec90bcbef1bee7,pylint/checkers/variables.py,0,3,3,11,14
vortex-exoplanet/VIP,d05486032b4462b15ae067757a3cedfc8b46a7e3,vip_hci/psfsub/svd.py,0,12,14,17,31
hyperspy/hyperspy,e423893f4643dbe05d0678db36963d59fb646bde,hyperspy/drawing/_widgets/range.py,7,6,488,91,579
materialsproject/pymatgen-db,b340aeac89174cf685ac28f925d5ae4832d2cecf,pymatgen/db/creator.py,0,12,19,26,45
ccxt/ccxt,bcc433ab8036bc423d7fde21007562daf47f64d2,examples/ccxt.pro/py/on-connected-user-hook.py,0,3,7,4,11
frappe/erpnext,aaf378e3400f2ad5f9738791f8d80ddf8b79a2d1,erpnext/controllers/item_variant.py,0,5,91,7,98
frappe/erpnext,494bd9ef78313436f0424b918f200dab8fc7c20b,erpnext/controllers/item_variant.py,0,17,70,125,195
ligo-cbc/pycbc,11142c548ee91c37c8819a2f5e81b65f78eac873,pycbc/workflow/pegasus_workflow.py,13,11,204,347,551
couchbase/couchbase-python-client,6d305796b094024c2ea07c8c963899999420f610,couchbase/options.py,106,5,172,1010,1182
psychopy/psychopy,0666040304552a3757059f306a2ebe1f76206daf,psychopy/constants.py,0,0,0,0,0
zhmcclient/python-zhmcclient,20e6961ad2310d5eda1ef8581db4f7c7bd63bad3,examples/discover_storage_group.py,0,2,112,74,186
spesmilo/electrum,3f3212e94d01a6c2f2bbdcf488eb81518f208e3e,electrum/lntransport.py,0,1,2,0,2
Splawik/pytigon,ed563833b51927eb790cbd9ed58c1e971eeda838,pytigon/static_src/pytigon_js/ajax_region.py,0,4,25,32,57
scylladb/scylla,43f2c55c5da34e431305cd9680dbb39e848dbbc4,scripts/merge-compdb.py,0,2,16,4,20
rdkit/rdkit,b53ee20b49bb3dce24486b73fa1ef7d69f9a9e84,Contrib/Glare/glare.py,0,1,1,1,2
Splawik/pytigon,05e636800ad64f36f88bf869391ad08f13ad29b8,pytigon/prj/_schwiki/schwiki/views.py,2,6,110,116,226
radiasoft/sirepo,99320f1a7c238f4bb08710043d305a3aadede107,sirepo/template/zgoubi.py,4,12,4,170,174
radiasoft/sirepo,48eb6a685f43ac18e8bb6184cd689455e6040331,sirepo/template/zgoubi.py,0,27,314,399,713
walles/px,4bb7f25b0ba3bfce592fc27ab6ce56bbbe11a2cf,px/px_pager.py,0,1,5,3,8
google/mobly,286c2f5819c1f640e4ea99d569bd6f3ab87dad9d,mobly/controllers/android_device_lib/snippet_client.py,0,2,7,4,11
GNOME/gnome-characters,1daaaf7cdea19732cf885a7b225b0c0535e31ef2,lib/gen-emoji.py,1,1,22,108,130
multitheftauto/mtasa-blue,583f2b94c3d1039fab249843781fa42a8cea1782,utils/localization/build_gettext_catalog_nsi.py,8,1,119,123,242
facebookresearch/ParlAI,73a395fd457d5f56463f4f72e5b65919db3f1f96,parlai/torchscript/modules.py,5,6,461,111,572
vnpy/vnpy,46470fe7435748cd71a341abaabee9285f536628,vnpy/trader/ui/widget.py,0,56,177,187,364
spesmilo/electrum,3f3212e94d01a6c2f2bbdcf488eb81518f208e3e,electrum/util.py,0,2,7,2,9
PyCQA/astroid,80b67a9c4c9bcbfb8a05a5311e269ae3bd55eec7,astroid/nodes/node_classes.py,0,9,8,14,22
rocky/python-uncompyle6,ccdd37611cf209389a43213a4ab43e1eb6e4815f,uncompyle6/semantics/pysource.py,0,2,171,187,358
rocky/python-uncompyle6,71bdc8dc6a3bfb601d5400657da964c072f38ce9,uncompyle6/semantics/pysource.py,0,2,20,0,20
rocky/python-uncompyle6,c42e16fafe82e486f132d8c71e169706392a9035,uncompyle6/semantics/pysource.py,0,2,1,2,3
pyrocko/pyrocko,a6b49f38a48108c00b4c15ab087e099b480d9c4b,src/trace.py,0,0,0,0,0
pyrocko/pyrocko,fabc2237cd9799fb4f0b87173437e3177790f5fd,src/trace.py,0,2,560,9,569
UtrechtUniversity/yoda-portal,30b4efb50ca299a0c429b395a27a8fadbda62e7d,user/user.py,0,1,5,8,13
isard-vdi/isard,d9ddbcfea1f8c8144853e591b577cddcc0ce69e9,api/src/api/libv2/api_desktops_common.py,0,3,5,15,20
spesmilo/electrum,8f36c9167de1bfd2505ef5516cd43661962b9c27,electrum/network.py,0,15,576,31,607
spesmilo/electrum,3f3212e94d01a6c2f2bbdcf488eb81518f208e3e,electrum/network.py,0,1,2,0,2
sqlalchemy/sqlalchemy,0bb00db558123209c3ffb8eab580dcf1823f36b4,lib/sqlalchemy/sql/schema.py,0,1,1,1,2
sqlalchemy/sqlalchemy,6f02d5edd88fe2475629438b0730181a2b00c5fe,lib/sqlalchemy/sql/schema.py,19,50,143,293,436
MyRobotLab/myrobotlab,ffaa76196309c0122d425c4d6ea4de186debfdd7,src/main/resources/resource/DiyServo/DiyServo.py,0,1,5,5,10
psi4/psi4,35b24baca552b95b311f2349806de0aa38f4333b,samples/psi4numpy/rhf-gradient/input.py,0,1,1,1,2
johntellsall/shotglass,2b616aca466325654cf2d5287081af266ec51d1a,shotglass/app/management/commands/render.py,0,1,9,8,17
walles/px,4bb7f25b0ba3bfce592fc27ab6ce56bbbe11a2cf,px/px_process_menu.py,0,1,6,2,8
spesmilo/electrum,3f3212e94d01a6c2f2bbdcf488eb81518f208e3e,electrum/lnworker.py,0,1,2,0,2
fja05680/pinkfish,b875daec838d5101f01b57872a0d22c13ed1e6e3,pinkfish/trade.py,0,7,7,8,15
androidx/androidx,d084e36006358ce3f43c0324f54c0a7487dc90da,development/project-creator/create_project.py,0,0,0,0,0
regardscitoyens/nosdeputes.fr,8f9eff2f1f8e967859a35cc5f51e919ffedde9e6,batch/hemicycle/parse_hemicycle.py,0,4,8,16,24
fja05680/pinkfish,b875daec838d5101f01b57872a0d22c13ed1e6e3,examples/170.follow-trend/strategy.py,0,7,17,12,29
LinkedEarth/Pyleoclim_util,53712a90f8ccfdf0c4dc96d24a7e80524cd94cc9,pyleoclim/utils/plotting.py,0,1,9,11,20
LinkedEarth/Pyleoclim_util,6d9b9bacfc3623ed5cd97d8c260816e7a777971b,pyleoclim/utils/plotting.py,0,7,54,71,125
radiasoft/sirepo,48eb6a685f43ac18e8bb6184cd689455e6040331,sirepo/template/opal.py,0,39,341,429,770
rocky/python-xdis,a1847231f8ef6d18e0256d32ed8ecd0374095743,xdis/bytecode.py,0,8,14,6,20
rocky/python-xdis,b7d9ac6f89464e1d766ec69cf67e521014e60849,xdis/bytecode.py,1,10,38,91,129
rackerlabs/django-DefectDojo,3b546499ab1e0aec5a438d233b84f56c40e118de,dojo/tools/tfsec/parser.py,0,3,7,13,20
apache/allura,1ca79c0c3c990b7ca1b641741d07c431f52c84fc,Allura/allura/lib/macro.py,0,1,24,20,44
diofant/diofant,8ab96042687f1d3e745e513d7e42038b8096f984,diofant/polys/polyroots.py,0,1,4,1,5
intelxed/xed,ef19f00de14a9c2c253c1c9b1119e1617280e3f2,mfile.py,0,2,7,4,11
acorg/acmacs-whocc,07bb6b929dca8d165acb5c1277ba2d2197b93f90,web/chains-202105/py/chart.py,0,1,17,19,36
xupingmao/xnote,feba5df4f521ae3455b985bc0b676de6132bd902,handlers/message/message.py,0,44,199,256,455
vilemnovak/blendercam,b33505a71cb448265f23956a44ad9b171a896eeb,scripts/addons/cam/simulation.py,0,13,49,31,80
radiasoft/sirepo,48eb6a685f43ac18e8bb6184cd689455e6040331,sirepo/pkcli/admin.py,0,5,22,35,57
ArduPilot/MAVProxy,160c77f2d5467051df3735abaf282d86057ff75c,MAVProxy/modules/lib/magfit.py,0,3,3,20,23
ccxt/ccxt,94fc8ffa87b25d3fde530061cfdc034c0f7e9a8c,examples/py/cli.py,0,3,8,10,18
ccxt/ccxt,2c396ece61f2000913a80ac41e75758b4b0d7f03,examples/py/cli.py,0,3,1,5,6
psi4/psi4,35b24baca552b95b311f2349806de0aa38f4333b,samples/psi4numpy/rhf-hessian/input.py,0,1,1,1,2
ecederstrand/exchangelib,ba452f7dd636b5c2a8ba85444e8467f68e568c56,exchangelib/services/common.py,0,5,77,0,77
ecederstrand/exchangelib,63a70df804054d875e25474468513873b7f72605,exchangelib/services/common.py,0,2,10,6,16
xupingmao/xnote,8ebb13390a1986649f131079fcfd8f9429eb9071,handlers/note/note_edit.py,2,9,4,41,45
radiasoft/pykern,9551826282bb90d1a4d73219af726637da75665c,pykern/pkinspect.py,0,8,11,12,23
walles/px,4bb7f25b0ba3bfce592fc27ab6ce56bbbe11a2cf,px/px_processinfo.py,0,1,8,6,14
Nic30/hwtHls,8c539092b986ef47ed6aec5b184b2390a91f2584,hwtHls/ssa/translation/fromLlvm.py,0,1,4,1,5
QuantConnect/Lean,cece811cceb83d27fdd4dcb6a4bb696163880f41,Algorithm.Python/ContinuousFutureRegressionAlgorithm.py,1,1,1,1,2
google/crosvm,ba4adc0efbb83a7e12dcca3402502344bbfe97db,rutabaga_gfx/src/generated/generate.py,0,1,128,139,267
DigitalCampus/django-oppia,0782515fe167587b66de27b6671852df51335fae,profile/models.py,0,4,41,17,58
mathieugouin/tradesim,5e676e5d9bbb3f2982fe9f9ac0e80372217516f2,finance_utils.py,0,1,12,5,17
mathieugouin/tradesim,03326b35877f263c8ee00a6f4e5c7ef1dd03ecb2,finance_utils.py,0,1,13,5,18
mathieugouin/tradesim,c3f1db4a573c42df9640e46ffc1ece2b43ebf5f5,finance_utils.py,0,1,10,6,16
ecederstrand/exchangelib,8adaee98f6227aa0de199a362d8bb9c96e51cf57,exchangelib/util.py,0,2,9,18,27
ecederstrand/exchangelib,6749d1c51bca86152143d44294c9b1510a2dc05d,exchangelib/util.py,0,1,2,0,2
ecederstrand/exchangelib,8559eb9f9116259c49d41f23e751705431204a90,exchangelib/util.py,0,4,10,8,18
specify/specify7,fcaf898c19c7c1050a161b6a2a919282b17a9768,specifyweb/interactions/views.py,0,0,0,0,0
PanDAWMS/panda-bigmon-atlas,83f786e0f88272bf4a1107b6a04f4e44fa8f69cf,atlas/prodtask/models.py,0,1,1,11,12
PanDAWMS/panda-bigmon-atlas,cf5af80b6e459c5a7fb5558bf93ad9820075dddf,atlas/prodtask/models.py,2,6,8,70,78
samuelclay/NewsBlur,b2cdff8a8510f2a6977ad8682c146f6294c4146d,utils/monitor_disk_usage.py,0,1,2,2,4
openstack/designate,c38810b15f968eb0e9e154e57240c702866363ee,designate/central/service.py,0,5,345,1,346
StanfordLegion/legion,695bfb518e7e470956df21482f85901b39fadab3,apps/circuit/python/circuit_sparse.py,0,7,9,15,24
Cog-Creators/Red-DiscordBot,febca8ccbb10d4a618a20c5a25df86ca3532acb0,redbot/cogs/alias/alias.py,1,6,31,8,39
JamesPHoughton/pysd,6b44a29d8d29bfac2d1525d7b46bff9384b94ff2,pysd/py_backend/data.py,1,2,4,33,37
wikimedia/pywikibot-core,576a51bd1cf5fa39c1214d09957f63d6d3891519,scripts/category_redirect.py,0,3,66,41,107
protwis/protwis,1dc064ddeb1f3b9bed2126964d2e761938497691,structure/views.py,0,7,265,265,530
protwis/protwis,4d4e9487946e1161735e549c59c3546a028aa1e5,structure/views.py,0,12,125,106,231
F5Networks/f5-ansible,e0501defc4ab642d777b05331b1eb92425270c89,ansible_collections/f5networks/f5_modules/plugins/modules/bigiq_regkey_license.py,0,7,4,27,31
isard-vdi/isard,5075b0825ba34972f87ca7b1f576a7eff37a4117,api/src/api/views/MediaViews.py,0,2,26,3,29
bitcoin/bitcoin,b54180303de0df9be7023577f35648225cf95443,contrib/seeds/makeseeds.py,1,5,34,25,59
streamlink/streamlink,68e60171b02fa9ba051735b8eff15e84e40af0c0,src/streamlink/plugins/filmon.py,1,4,162,114,276
tobi-wan-kenobi/bumblebee-status,9a6e61173f6547673528701b622c7204c092f966,bumblebee_status/modules/contrib/publicip.py,3,1,54,80,134
WeblateOrg/weblate,ffd9a3898666ac3fd544513b6efe4c27e36b8d71,weblate/trans/views/js.py,0,0,0,0,0
WeblateOrg/weblate,1804a951c8ae9199d23099a8ec322134ee5b45bc,weblate/trans/views/js.py,0,1,63,1,64
jim-easterbrook/Photini,5757dd45227ea824e7ad0b444bea48df04b19f2a,src/photini/spelling.py,0,1,17,14,31
jim-easterbrook/Photini,b920a3b66f0a160269606e3265a4253fe792fb20,src/photini/spelling.py,0,6,73,10,83
samuelclay/NewsBlur,f91b5164dc6495d38a79e2aeb2c05ee11f404f32,vendor/readability/readability.py,0,0,0,0,0
samuelclay/NewsBlur,6dcfc2ae15d8275b07853a0ad0b9ffaaab19d5b5,vendor/readability/readability.py,0,1,6,7,13
facebook/wangle,20b828ba11d103c4a450af9be0d2c0ebafcff8ff,build/fbcode_builder/getdeps/builder.py,0,1,50,0,50
nortikin/sverchok,a89e4cc9575756c1b0e62834e4e50b7a0b286dd6,core/update_system.py,0,0,0,0,0
learningequality/kolibri,5cf898d7e47da9ffc7396c9ee891107468f4e715,kolibri/core/tasks/worker.py,0,0,0,0,0
learningequality/kolibri,22541940e291494ad285d92670deab8c087d53b5,kolibri/core/tasks/worker.py,0,0,0,0,0
mitmproxy/mitmproxy,bbc65e5f375693ec32d50b805cdb369a607f0b67,mitmproxy/master.py,1,3,69,22,91
pikepdf/pikepdf,49133de4574a3d21c6b363e345d2662854bd2027,src/pikepdf/models/metadata.py,0,6,9,11,20
mapillary/OpenSfM,318a77020a4692f65c126387462be5b942f86034,opensfm/io.py,0,13,25,30,55
MontrealCorpusTools/Montreal-Forced-Aligner,3944163b02ef1cf2796ce7bc77222c33b071d961,montreal_forced_aligner/g2p/generator.py,4,13,25,80,105
nschloe/matplotlib2tikz,b33ad8a0c58b2fd6d2404a63a030346e03820d77,src/tikzplotlib/__about__.py,0,1,10,1,11
abrt/retrace-server,f7490a06ba64016527190930c7a76d6ee0d0a64b,src/retrace/plugins.py,0,2,3,3,6
bsc-dd/hecuba,eed72b4ba2e988e34c0182bbb1721f97c9a919bb,hecuba_py/hecuba/storageobj.py,0,5,16,40,56
oceanobservatories/mi-instrument,a882a3d7b4a798209a86eda61f1c7d291ad95465,mi/dataset/driver/dofst_k/wfp/coastal_dofst_k_wfp_telemetered_driver.py,0,3,75,8,83
mikf/gallery-dl,7958995398f863c081bce7995ca8ea6b0f39f99d,gallery_dl/path.py,0,0,0,0,0
choderalab/perses,9beb9b0602893c501381967422ec1f048ba67b8a,perses/app/fah_generator.py,0,18,216,365,581
jim-easterbrook/Photini,320983e9eba389e3a8d70fb38e462466be164efe,src/photini/photinimap.py,0,2,49,1,50
jim-easterbrook/Photini,86ba2dc4268921271245f92b33c46b73bec0ce52,src/photini/photinimap.py,2,4,9,15,24
actionless/oomox,36ab32efe51bd2171017e60ab5659a12e9396b18,oomox_gui/export_common.py,0,2,26,0,26
mmgen/mmgen,4631ba7e58f880a50c909a522a13fdf4401f0b08,mmgen/main_addrimport.py,0,2,40,10,50
devilry/devilry-django,e9389259f38d47e8b9ff0ffe3a960ba608045e9c,devilry/devilry_account/crapps/account/select_language.py,0,2,9,3,12
FPGAwars/apio,0c251c6e9f89e51f79caf281c0ecdb5d7b4da2af,apio/profile.py,0,1,0,2,2
walles/px,69d4eea55167097029e25bcd4eb7f392a38e582a,px/px_top.py,0,6,19,15,34
fkie-cad/FACT_core,04750fe7d2f7cdbc65788dee80b94ccd4b6b2ba2,src/storage/db_interface_frontend.py,18,1,275,381,656
fkie-cad/FACT_core,14caadab2087fe5995c85ff89c8ee3f46b198dfa,src/storage/db_interface_frontend.py,16,1,283,372,655
fkie-cad/FACT_core,3cf5359036d3ba7a2e88f1e9a4b295f7d24a76fe,src/storage/db_interface_frontend.py,17,1,291,378,669
learningequality/kolibri,dd2bd2c163bb33f35afffeea4609636d8f213652,kolibri/core/deviceadmin/utils.py,0,0,0,0,0
GoogleCloudPlatform/python-docs-samples,69dbd8cdd097d26e85da59ff52e851a336957d88,cloud-sql/mysql/sqlalchemy/main.py,1,1,253,16,269
Rapptz/RoboDanny,d4618756d758e7226bc6c8e9fabcf1fb08faf2f8,cogs/stars.py,2,48,101,146,247
lief-project/LIEF,dfeaa20a39450456555d351ef023d3b81c12a20c,.github/deploy.py,9,8,70,206,276
isard-vdi/isard,5075b0825ba34972f87ca7b1f576a7eff37a4117,api/src/api/views/PublicView.py,0,2,21,9,30
facebookincubator/mvfst,1d99b98b8dbb001b2e766a0f0c4fabd501f8d692,build/fbcode_builder/getdeps/builder.py,0,1,50,0,50
mozilla/addons-server,91d1b68f0df760cbb644e0e671b2b3d8f9caae11,src/olympia/accounts/utils.py,1,2,2,1,3
mozilla/addons-server,d54aa5664284b01e7e9513d90a39bd23fb3b8029,src/olympia/accounts/utils.py,0,3,83,0,83
secdev/scapy,52214c4582bfe843ac8641c196763fc7cb57bcbd,scapy/contrib/automotive/doip.py,0,1,14,1,15
Erotemic/ubelt,f22340dbc85748f6623ec1e8e75b89f5fccf4d49,ubelt/util_indexable.py,0,3,14,3,17
xpybuild/xpybuild,de5df3041caaf820f584c2594ea24c626879d0c1,xpybuild/targets/docker.py,0,1,5,7,12
crosscompute/crosscompute,06c97e5b962c35a79b6a0272246c5d45ab006018,crosscompute/routines/variable.py,4,15,98,87,185
spesmilo/electrum,4f9e4c520f29bfffd51738213bebfb514967e7ba,electrum/transaction.py,0,1,4,1,5
medialab/gazouilloire,bbca2fec79927ae195b99ae58820f340d074563d,gazouilloire/daemon.py,2,5,49,25,74
isard-vdi/isard,89c3fc62027abd85f96cb4d7e50a3718633e30cd,api/src/api/libv2/api_socketio_deployments.py,0,4,26,10,36
esp8266/Arduino,07789808b941d556f8ac1bd482342561a0e37d12,tools/upload.py,0,3,15,20,35
tulip-control/tulip-control,9f5c240fce36548975073cfc7add2571a58aba2f,tulip/graphics.py,1,5,12,12,24
tulip-control/tulip-control,9c06246d9a971efa0ec92a30c8a4cb2a9ab3c9da,tulip/graphics.py,1,4,11,13,24
oceanobservatories/mi-instrument,a882a3d7b4a798209a86eda61f1c7d291ad95465,mi/dataset/driver/dofst_k/wfp/coastal_dofst_k_wfp_recovered_driver.py,0,3,74,8,82
cobbler/cobbler,a463afe8802acd3bf73ffe752381d09218187713,cobbler/api.py,1,2,0,2,2
cobbler/cobbler,cd35d1e945a690ae2ac64142ce8d00c2f72a6687,cobbler/api.py,1,2,14,20,34
frappe/erpnext,a585dff6fd05c885c6b4c35892f48d1fdf644487,erpnext/stock/doctype/serial_no/serial_no.py,0,3,7,18,25
frappe/erpnext,4aabe9756548299a94dff905e5f75bc9ed834531,erpnext/stock/doctype/serial_no/serial_no.py,1,1,11,51,62
facebook/folly,c3fbb5ec80484ef32a9494562de9f5c6df8123cb,build/fbcode_builder/getdeps/builder.py,0,1,50,0,50
spulec/moto,2957a51e4e8abbb15343bc823a0c7ef89e903e42,scripts/get_amis.py,0,2,22,3,25
espressif/esp-idf,069b82401cf472185b521e3af0e3beecfdf572d7,tools/esp_prov/transport/transport_ble.py,1,4,29,14,43
inveniosoftware/invenio-communities,14c4768e1c8d2ab2ed2cb254fc82ffd5a5d3b779,invenio_communities/communities/records/systemfields/access.py,0,5,35,2,37
espressif/esp-idf,44f3c19fa9632c26cfd2ba786c6dfe8eac4bbbac,tools/idf_py_actions/core_ext.py,0,13,49,27,76
jjjake/internetarchive,f2dc696813f104a75d2a6fb766ce8848d5443602,internetarchive/cli/ia_download.py,0,4,11,8,19
commaai/openpilot,39099120a5e45ed46dffca42f0076becd0042e55,tools/replay/can_replay.py,0,0,0,0,0
commaai/openpilot,2130eae8b1b68fbbdd939792f13c8d1e81a22cea,tools/replay/can_replay.py,0,0,0,0,0
candlepin/subscription-manager,ddf4d6fd4f68c8e0c5e3c56aac5a12ceb0b3595c,src/rhsmlib/facts/firmware_info.py,0,3,35,1,36
tomerfiliba/plumbum,72e8c1dbac47f93e714ff36f6b50f16f5e0e8571,plumbum/fs/atomic.py,0,4,6,5,11
google/report2bq,f5245cea6111a647d6268e376cfb88b0e3252db9,application/cli/key_upload.py,0,4,30,4,34
WeblateOrg/weblate,1c494cd053c3578984d551576eaec5e1bb7061de,weblate/machinery/google.py,0,2,6,4,10
facebook/watchman,088dafca14ad82d99517b511099b13d67d311213,build/fbcode_builder/getdeps/builder.py,0,0,0,0,0
openstack/cinder,6dda4bec2149d0938c692cbf5bd13165d7b769f7,cinder/volume/drivers/stx/client.py,0,1,8,0,8
DIRACGrid/WebAppDIRAC,5ea7197e28cc54406b3f4fd58a249d131b55cff1,src/WebAppDIRAC/WebApp/handler/RequestMonitorHandler.py,2,1,157,141,298
walles/px,7bb865dda0aff65f7dbeab86e7eadc4dbdcc92f0,px/px_install.py,0,1,2,2,4
walles/px,7bb865dda0aff65f7dbeab86e7eadc4dbdcc92f0,px/px_file.py,0,3,3,7,10
ms0/pymath,e340a4c4cad59f19774dc659f9f3a1242720760e,poly.py,0,15,95,19,114
google/atheris,714394b54dfc39e439dd83ef977b5dc85650ae06,src/import_hook.py,2,11,59,116,175
hasgeek/funnel,a16e3a5e0a7dd9bbd9157ca9d291519af3f3f750,funnel/registry.py,0,2,6,7,13
alorence/django-modern-rpc,4ec9b787df92724715420df57474998c2466816e,modernrpc/views.py,0,3,32,7,39
alorence/django-modern-rpc,b5d90ba35daef0f92bcd16f36479269dec475d2f,modernrpc/views.py,0,4,30,7,37
edgedb/edgedb,980ad88b91d105760dc9f97c84e0fd634fd2ae29,edb/server/main.py,0,15,415,28,443
edgedb/edgedb,70b2c35b8c2c6f3a5d44e868930c77a79082d9d9,edb/server/main.py,0,6,22,10,32
edgedb/edgedb,135d9e8550f7532c215091b1fc20551f9915d194,edb/server/main.py,0,3,31,0,31
prusa3d/Prusa-Firmware,0d7680dbf7d1142dd803e90020474eedc3977069,lang/lang-check.py,1,2,255,211,466
pallets/werkzeug,70a61859d2ab0d628aeb6189b94d0fce45345373,src/werkzeug/debug/tbtools.py,16,6,420,242,662
OpenBfS/dokpool-plone,4d263af666a44e9d028b3902de14ffda449190bb,Plone/src/docpool.localbehavior/docpool/localbehavior/adapter.py,0,1,9,6,15
matrix-org/synapse,6927d8725430356880e212edf0c61bf32cb071c3,synapse/visibility.py,2,10,106,128,234
mne-tools/mne-python,6e2c52c592be02de3c798c98b21cfdc1d6e264ad,mne/viz/backends/_qt.py,0,3,28,4,32
walles/px,194f4ea6e71da68002f0832312c3b16de0c49ac8,px/px.py,0,7,8,13,21
hardbyte/python-can,f1808ed5e8e20ebbf489713fe5da4a44fea079f0,can/exceptions.py,0,2,1,2,3
GoogleCloudPlatform/python-docs-samples,a698c15362b486f650de93e2c206221bf8aa3331,cloud-sql/sql-server/sqlalchemy/main.py,1,1,276,16,292
frappe/erpnext,cff91558d4f380cc7566d009ea85ccba36976f69,erpnext/manufacturing/doctype/bom_update_tool/bom_update_tool.py,2,2,87,33,120
frappe/erpnext,63d892454ba78b63ffb5a5c58492f4a7df2962e0,erpnext/manufacturing/doctype/bom_update_tool/bom_update_tool.py,2,1,108,39,147
walles/px,fe4b7ca06b2d8be5a25292fe2331d22a705b7b19,px/px_pager.py,0,3,3,3,6
gkunter/coquery,e86d4299e2d0b688e1f9cb2d3b0dfe9c13eb1f07,coquery/gui/orphanageddatabases.py,0,6,26,19,45
alorence/django-modern-rpc,b5d90ba35daef0f92bcd16f36479269dec475d2f,modernrpc/handlers/base.py,9,2,86,51,137
spesmilo/electrum,5faef838741f1fed1fd2b1edc2dade7702eb9948,electrum/gui/qt/lightning_tx_dialog.py,0,2,15,0,15
scalyr/scalyr-agent-2,2d097fcfe1c51e7e3e90c2cfe2fd71791a30b5fb,build_package.py,1,17,81,148,229
scalyr/scalyr-agent-2,4ff9efa148690b8b5ef108d20ed536178e435e8c,build_package.py,0,3,15,2,17
coreboot/chrome-ec,205bf7ab0a862acff1ba964483c651b86e8406e5,zephyr/zmake/zmake/multiproc.py,6,6,153,166,319
Rapptz/discord.py,940bdb988aa14dcdd0e310dfdbfddd780cbd8ba8,discord/user.py,0,1,19,2,21
fastai/fastai,2285abc3f1652af4c2929af0f5230b131da498f6,fastai/collab.py,0,1,3,3,6
ansible/ansible-lint,77813a2dfac691677c3c69465432e2dc76514cd7,src/ansiblelint/_internal/rules.py,0,1,1,1,2
kizniche/Mycodo,9851683d36fb95fb0412b0f1d926b71051f5ec34,mycodo/controllers/controller_trigger.py,0,1,19,0,19
isard-vdi/isard,5075b0825ba34972f87ca7b1f576a7eff37a4117,api/src/api/libv2/isardViewer.py,0,6,11,14,25
couchbase/couchbase-python-client,6d305796b094024c2ea07c8c963899999420f610,couchbase/durability.py,11,3,118,111,229
scalyr/scalyr-agent-2,3d6b733554f2089105509041fad5f150139758c3,scalyr_agent/third_party/urllib3/contrib/_securetransport/low_level.py,3,14,39,93,132
scalyr/scalyr-agent-2,1d9f45b615aea44acae1392b1ca48827de1a5159,scalyr_agent/third_party/urllib3/contrib/_securetransport/low_level.py,3,14,39,93,132
AlertaDengue/AlertaDengue,597c41d616143a662ec0768c2580be215f3e8a9a,AlertaDengue/dados/views.py,0,6,54,73,127
spesmilo/electrum,f2d58d0e3f97975d4dcfcbcacc96d7e206190ef6,electrum/lnpeer.py,2,12,48,39,87
spesmilo/electrum,87a080d30e0897a5e9ec865a266eba7ee74a87d0,electrum/lnpeer.py,2,8,85,97,182
spesmilo/electrum,f1b5069c78a9994ec13f5c1109052d0602bf0497,electrum/lnpeer.py,0,12,31,21,52
spesmilo/electrum,b2f84187bc1e45f7274d82dd058b160ff1df5a0d,electrum/lnpeer.py,1,6,107,119,226
openstack/designate,13d98df2932f891957c04ea43a26934372b90d95,designate/worker/processing.py,0,1,7,1,8
carthage-college/django-djforms,1bf72eba2166f1c06be3639990691f46ca86ab9e,djforms/scholars/views/forms.py,0,2,19,11,30
kizniche/Mycodo,f9e62fbcece09676deaa99c4bfd1b0f6aaf1af38,mycodo/utils/update_dependencies.py,1,6,38,17,55
SpaceVim/SpaceVim,b730079c880a69b8ff773bb6b3134613e91b919f,bundle/deoplete.nvim/rplugin/python3/deoplete/logger.py,0,2,13,4,17
yeatmanlab/pyAFQ,8b93da5eedde648e75d366b67b7ab2b02271376c,AFQ/api/group.py,1,9,125,78,203
mdiller/MangoByte,54346e76e261f87d99edd826c1df097f9dffd992,cogs/dotastats.py,0,1,7,9,16
mdiller/MangoByte,2785c62903aad8cf870d6caf756d4f92f6f9be13,cogs/dotastats.py,8,17,354,310,664
facebookexperimental/eden,4da937e55b1717375da2b3e35e19b6b32bbb0294,build/fbcode_builder/getdeps/builder.py,0,1,50,0,50
pypa/pip,728e4fe7c4168f62b8f47721aa56576cce5e46fb,src/pip/_internal/cli/progress_bars.py,0,3,253,2,255
lsst-sqre/ltd-keeper,4f05b0cf8e3aab74e7010f5536f94916eb214215,keeper/v2api/builds.py,0,3,0,4,4
FPGAwars/apio,0c251c6e9f89e51f79caf281c0ecdb5d7b4da2af,apio/managers/scons.py,0,1,0,2,2
GoogleCloudPlatform/python-docs-samples,ecb694736944368dc2f8624e377e1cd350bd93ba,cloud-sql/postgres/sqlalchemy/main.py,1,1,267,16,283
openstack/oslo.db,22c602f075795b6d5ecbbc2e229817f759613ea2,oslo_db/sqlalchemy/utils.py,0,1,127,0,127
facebook/bistro,de1607bcd6e7bcd7d096568739bbb5512a035cb3,build/fbcode_builder/getdeps/builder.py,0,1,50,0,50
savoirfairelinux/opendht,383c53d71fce2b235ae2c3ab1aa2961cf168830b,python/tools/dht/virtual_network_builder.py,1,1,99,232,331
zulip/zulip,a1fa2a8cf502f93bdead1f12fbde34fb12499342,zerver/lib/scim.py,0,2,62,1,63
lablup/backend.ai-manager,f4d381898fc784659bb6f7fbf2065057c22fdb8e,src/ai/backend/manager/api/session.py,0,10,61,65,126
pytorch/fairseq,5551a1995bea28e47b388dc21fe683efee2d53f6,examples/truncated_bptt/transformer_xl_model.py,0,1,12,0,12
facebook/fbthrift,ab1951715db58cb43a7040420ea9dc06042ab298,build/fbcode_builder/getdeps/builder.py,0,1,50,0,50
ansible/ansible,47faa6e206ccd697b4050062147a5d3242435597,lib/ansible/vars/clean.py,0,1,7,1,8
homecon/homecon,fe95dbc29d1bf6c5e940e1f01db57c8f95446801,backend/src/homecon/plugins/timeseries/timeseries.py,2,2,64,68,132
JamesPHoughton/pysd,b595cfa1ea3e11ecdb29a35e634b2103b72e4026,pysd/py_backend/statefuls.py,2,8,40,29,69
spesmilo/electrum,5398b9d9c9f7dc1bebc99a85a1ef22d6a75d424b,electrum/gui/qt/qrtextedit.py,0,3,99,10,109
Der-Eddy/discord_bot,836bb60b2cabca69ef49bd55c72354ade1e7d3f3,main.py,2,5,65,71,136
Der-Eddy/discord_bot,8f2741356287e68cea624972f27beb6f55454d6c,main.py,0,4,4,9,13
DIRACGrid/WebAppDIRAC,1451ed5e9fbd005611ec86751c08c961621c7daf,src/WebAppDIRAC/WebApp/handler/ProxyManagerHandler.py,1,6,76,51,127
opencobra/cobrapy,ec77d037aa550f5464ccc1639ab049d0156b2007,src/cobra/core/metabolite.py,0,13,65,109,174
MontrealCorpusTools/Montreal-Forced-Aligner,6ee755d8a1f37fb7090146328d40ed27f35e7b8e,montreal_forced_aligner/alignment/multiprocessing.py,12,22,240,485,725
jumpserver/jumpserver,031077c2983300ed539d37462861c2048ecd7e11,apps/authentication/mixins.py,2,6,76,10,86
dpazel/music_rep,709dc57898299071988e499f243c90b5ba2aa5b5,tonalmodel/interval.py,2,4,5,8,13
nextstrain/augur,43ea88b2960c87e9267b9305ee8cdfe41a5a933c,augur/parse.py,0,2,2,13,15
tum-pbs/PhiFlow,7a3671d31839a3e0d8403bb62f07ed1858f8187c,phi/vis/_dash/viewer.py,0,1,18,5,23
leprikon-cz/leprikon,9741581c082363d4b7bbb846f383fa3483ae1157,leprikon/middleware.py,0,2,14,1,15
MarxMustermann/OfMiceAndMechs,81ddb6fa26d7d9e88978c3f0f5c5be87ef0314d5,executeMe.py,0,8,524,16,540
MarxMustermann/OfMiceAndMechs,36225a0f59e57fea439fdad2567ff6befb25dbef,executeMe.py,0,6,486,1,487
MarxMustermann/OfMiceAndMechs,be19c58a05accb18aa785c8a4382fd59013c4a00,executeMe.py,0,2,0,2,2
Azure/azure-sdk-for-python,ef91a8dfa664457f6ece5f4e18f86dbfa3f168d2,scripts/auto_release/main.py,56,2,423,497,920
elifesciences/builder,457d403eac7cb9643bdfb8d827260c71a3e147a8,src/master.py,0,6,12,26,38
PMEAL/OpenPNM,a7b8574a6c1b29b0a6610fb8475834a1cbd61cf5,openpnm/algorithms/_invasion_percolation.py,4,11,162,162,324
nortikin/sverchok,a3e03561af39175f52e206d60e7caa0a9273e7dd,core/sockets.py,0,3,9,1,10
nortikin/sverchok,73d0762e6f85038fc6f207fcf02da10b45b10db8,core/sockets.py,0,7,40,24,64
nortikin/sverchok,a42c0616be644db58262ffc954acac215d40d6de,core/sockets.py,0,9,41,23,64
ansible/ansible-lint,77813a2dfac691677c3c69465432e2dc76514cd7,src/ansiblelint/utils.py,0,1,1,1,2
oceanobservatories/mi-instrument,a882a3d7b4a798209a86eda61f1c7d291ad95465,mi/dataset/driver/flort_kn/stc_imodem/flort_kn__stc_imodem_driver.py,2,3,27,7,34
tensorflow/decision-forests,8fbd3559619f7ba976c00c7922916aa509d50181,tensorflow_decision_forests/tensorflow/core.py,1,7,13,85,98
tensorflow/decision-forests,1234117e3be42ca30505f355febfc93bf4ae7276,tensorflow_decision_forests/tensorflow/core.py,1,6,13,81,94
radiasoft/pykern,e1a092898389436513f3525d405c4ce403064626,pykern/pkcollections.py,2,5,11,125,136
isard-vdi/isard,5075b0825ba34972f87ca7b1f576a7eff37a4117,api/src/api/libv2/api_hypervisors.py,0,3,4,7,11
Azure/azure-sdk-for-python,64ba5542b1b9383ee5c7f05a71daa2885b198c3b,sdk/loganalytics/azure-mgmt-loganalytics/azure/mgmt/loganalytics/models/_models_py3.py,0,78,164,160,324
couchbase/couchbase-python-client,49e799340979da26962b2a813a8abbe5141f3883,couchbase/result.py,0,1,3,9,12
Azure/azure-sdk-for-python,663c846e4d24166f0e76092a80989cfd08521bf2,sdk/sql/azure-mgmt-sql/azure/mgmt/sql/models/_models_py3.py,20,360,752,1139,1891
isard-vdi/isard,d0ea9310fd387e1714be57ad992c487f87e320ba,api/src/api/libv2/quotas.py,0,2,45,7,52
mongodb/mongo-python-driver,a0fe7c03af08adde0c893071e1664b43570b9841,pymongo/errors.py,0,1,1,1,2
Frikanalen/frikanalen,a86977cdb2925aa59cc1feaf1200f1661955f740,packages/fkweb/fkweb/settings/local.py,0,1,23,23,46
python-control/python-control,e2f76df5e6ae2f562a8040ad33f1ea40838994d3,examples/pvtol-lqr.py,0,10,71,56,127
litex-hub/linux-on-litex-vexriscv,8d52c065021195dbea71a83f7b16f365592e1554,make.py,0,16,22,4,26
nortikin/sverchok,6019f8e84476e257bb24b026105fcf4d22ce0b4c,nodes/script/mesh_eval.py,0,4,4,1,5
Wintermute0110/plugin.program.advanced.emulator.launcher,a5052b2af10fd5c1ce212ac512f5b2d176a6e684,dev-scrapers/common.py,0,2,34,29,63
Azure/azure-sdk-for-python,67246066a1735df6cdb4542ddf9a108bfb0c25b8,sdk/automation/azure-mgmt-automation/azure/mgmt/automation/models/_models_py3.py,38,330,1485,4003,5488
gkunter/coquery,d12786b57ac3f3c5964d57dc052bef6e925ccbc0,coquery/installer/coq_install_buckeye.py,0,17,164,112,276
sde1000/quicktill,13cecf640046e7c701ac1cfbfeb8e6f3c7707494,quicktill/tillweb/spreadsheets.py,0,15,43,67,110
couchbase/couchbase-python-client,6d305796b094024c2ea07c8c963899999420f610,couchbase/management/collections.py,0,1,242,46,288
couchbase/couchbase-python-client,b2032bd2d65b19cd672a62b28ba864c1ce391826,couchbase/bucket.py,0,0,0,0,0
couchbase/couchbase-python-client,6fbe6ce0198e04384f43f0f5404b2ce1a1a79b84,couchbase/bucket.py,0,3,2,14,16
couchbase/couchbase-python-client,6d305796b094024c2ea07c8c963899999420f610,couchbase/bucket.py,7,1,385,90,475
MTG/essentia,69490c19263011d582bbb540ce96c20749214e49,src/examples/python/musicbricks-tutorials/6-harmonic_mask.py,0,3,28,26,54
couchbase/couchbase-python-client,6d305796b094024c2ea07c8c963899999420f610,couchbase/subdocument.py,11,7,178,293,471
psi4/psi4,b874356fc07d5cb946292bca4d0c7338f280bdeb,psi4/driver/pluginutil.py,0,6,13,20,33
apache/qpid-dispatch,cbb4aeaf05dde27a9a4f590579f472cb1553d878,python/qpid_dispatch/management/client.py,0,0,0,0,0
apache/qpid-dispatch,d8a1f40ebdf198f798745678c78e99d045e3aa74,python/qpid_dispatch/management/client.py,0,10,19,18,37
dpressel/baseline,746fcf5fc8ec939094fb4f50939e15eddd7428df,baseline/tf/tagger/train.py,14,1,8,395,403
isard-vdi/isard,5075b0825ba34972f87ca7b1f576a7eff37a4117,api/src/api/libv2/api_templates.py,0,4,5,18,23
Splawik/pytigon,768e36ffae261ba700753613474b75ec07b6742f,pytigon/schserw/settings.py,0,5,8,14,22
UCBerkeleySETI/blimpy,18a81317920d4ffb239760b06301ff632ae38044,blimpy/plotting/plot_utils.py,0,1,2,0,2
sde1000/quicktill,d109eb3a3438ed5fea2daa4cb1b1ee2235811a46,quicktill/td.py,43,18,103,475,578
sde1000/quicktill,13cecf640046e7c701ac1cfbfeb8e6f3c7707494,quicktill/td.py,0,7,18,45,63
sde1000/quicktill,13cecf640046e7c701ac1cfbfeb8e6f3c7707494,quicktill/localutils.py,0,19,34,73,107
isard-vdi/isard,5075b0825ba34972f87ca7b1f576a7eff37a4117,api/src/api/libv2/api_desktops_persistent.py,0,14,17,21,38
couchbase/couchbase-python-client,6d305796b094024c2ea07c8c963899999420f610,couchbase/exceptions.py,75,3,1415,599,2014
facebook/fbthrift,997a6a0a77ba54de4d6d6481bbc410a2484f5b1e,thrift/lib/py/transport/THttpClient.py,0,4,23,10,33
digitalocean/netbox,7c60089692d853c7db2bb3af623bf28347697596,netbox/extras/filters.py,0,1,36,0,36
Azure/azure-sdk-for-python,cbec3383039ffeb46760268d1a8f81cf1b4d2219,sdk/storage/azure-mgmt-storagecache/azure/mgmt/storagecache/models/_models_py3.py,10,74,205,432,637
couchbase/couchbase-python-client,6d305796b094024c2ea07c8c963899999420f610,couchbase/n1ql.py,8,1,170,93,263
CumulusNetworks/ifupdown2,a98b38984cd20566f862d5c2797071ae38d17242,ifupdown2/ifupdown/graph.py,0,1,3,4,7
UCBerkeleySETI/blimpy,2c8ffa88ca3089f21f546cfbf3c6c92aa01d6532,blimpy/waterfall.py,3,12,269,27,296
UCBerkeleySETI/blimpy,3b6f68f1170a0d4131fa10bce6fdd030a3cb2cda,blimpy/waterfall.py,0,5,66,65,131
dkriegner/xrayutilities,c8e08af5129129e2d8acbb9c52fc7fd7f2114f3f,examples/simpack_xrr_SiO2_Ru_CoFe_IrMn_Al2O3.py,0,3,3,11,14
Azure/azure-sdk-for-python,3da721fe4321df77bd2482299745432bc88ae36e,sdk/cosmos/azure-mgmt-cosmosdb/azure/mgmt/cosmosdb/models/_models_py3.py,4,198,7737,4569,12306
sde1000/quicktill,13cecf640046e7c701ac1cfbfeb8e6f3c7707494,quicktill/event_glib.py,0,4,5,6,11
Azure/azure-sdk-for-python,7eeaca97c41bc18ec66f325eef5e6910efde6e12,sdk/appservice/azure-mgmt-web/azure/mgmt/web/v2018_02_01/models/_models_py3.py,0,292,590,561,1151
Azure/azure-sdk-for-python,92a9b682b021d22934458683db70dd3d9d7f01d0,sdk/consumption/azure-mgmt-consumption/azure/mgmt/consumption/models/_models_py3.py,0,37,86,79,165
geodynamics/burnman,4742e0b98c7a8a83decb311d41732b870555f539,burnman/minerals/Sundman_1991.py,0,2,4,3,7
couchbase/couchbase-python-client,6d305796b094024c2ea07c8c963899999420f610,couchbase/management/search.py,2,1,495,109,604
geodynamics/burnman,4742e0b98c7a8a83decb311d41732b870555f539,burnman/minerals/JH_2015.py,0,13,77,96,173
lowRISC/opentitan,8fef8b556d338e38808105b3a183b94e347ef9c8,hw/ip/otbn/util/shared/information_flow_analysis.py,0,14,35,44,79
ms0/pymath,e340a4c4cad59f19774dc659f9f3a1242720760e,bch.py,0,1,2,3,5
gisce/enerdata,dbe11ea7badee4eadaee0336b488a37719675d2f,spec/datetime/station_spec.py,0,1,4,3,7
Azure/azure-sdk-for-python,7eeaca97c41bc18ec66f325eef5e6910efde6e12,sdk/appservice/azure-mgmt-web/azure/mgmt/web/v2016_03_01/models/_models_py3.py,0,123,242,233,475
isard-vdi/isard,5075b0825ba34972f87ca7b1f576a7eff37a4117,api/src/api/libv2/api_desktops_common.py,0,3,59,60,119
digitalocean/netbox,12fbd349628b94c737cf35b1284f076d87c2ef6c,netbox/extras/api/customfields.py,0,2,34,1,35
Wintermute0110/plugin.program.advanced.emulator.launcher,737acaa7f27487c80f72f4f31d3998d6089cd4f4,resources/utils.py,0,1,2,1,3
Wintermute0110/plugin.program.advanced.emulator.launcher,3a945257574e5a90a635807ac5bef353b8102d97,resources/utils.py,38,27,566,118,684
gkunter/coquery,06356d427456f03b80c9cb87cc4d2100aacc2229,coquery/visualizer/linechart.py,0,1,10,2,12
isard-vdi/isard,5075b0825ba34972f87ca7b1f576a7eff37a4117,api/src/api/libv2/api_desktops_nonpersistent.py,0,8,18,13,31
lark-parser/lark,77b7f499215dd4c0e10071f6d536991e3b4308c5,examples/advanced/qscintilla_json.py,0,1,1,1,2
isard-vdi/isard,5075b0825ba34972f87ca7b1f576a7eff37a4117,api/src/api/libv2/helpers.py,0,3,5,9,14
Azure/azure-sdk-for-python,3a56459f806388f67d367c5cd1e8896143aeff11,sdk/media/azure-mgmt-media/azure/mgmt/media/models/_models_py3.py,2,207,458,530,988
couchbase/couchbase-python-client,6d305796b094024c2ea07c8c963899999420f610,couchbase/management/users.py,0,1,750,58,808
Azure/azure-sdk-for-python,da9039efb0dad2dcd2d604d2d7bfac512f203d78,sdk/rdbms/azure-mgmt-rdbms/azure/mgmt/rdbms/mysql/models/_models_py3.py,0,51,221,217,438
xupingmao/xnote,6ad5b3a65dfe3dcca2ac1104306a04e281e1dbb2,handlers/message/message.py,4,14,96,117,213
geodynamics/burnman,4742e0b98c7a8a83decb311d41732b870555f539,burnman/classes/combinedmineral.py,0,15,55,57,112
couchbase/couchbase-python-client,6d305796b094024c2ea07c8c963899999420f610,couchbase/collection.py,109,1,1694,623,2317
Azure/azure-sdk-for-python,4b3fdb5157ff11432ac9be20b30873ec850af783,sdk/chaos/azure-mgmt-chaos/azure/mgmt/chaos/models/_models_py3.py,0,32,92,94,186
geodynamics/burnman,3ce21a62a628a506d8c47aa7938b1b4d0a195a1c,burnman/minerals/RS_2014_liquids.py,0,0,0,0,0
geodynamics/burnman,4742e0b98c7a8a83decb311d41732b870555f539,burnman/minerals/RS_2014_liquids.py,0,2,14,11,25
couchbase/couchbase-python-client,6d305796b094024c2ea07c8c963899999420f610,couchbase/management/analytics.py,0,1,705,182,887
isard-vdi/isard,5075b0825ba34972f87ca7b1f576a7eff37a4117,api/src/api/libv2/api_users.py,0,14,51,48,99
couchbase/couchbase-python-client,6d305796b094024c2ea07c8c963899999420f610,couchbase/search.py,4,1,1708,119,1827
geodynamics/burnman,4742e0b98c7a8a83decb311d41732b870555f539,burnman/minerals/KMFBZ_2017.py,0,8,13,16,29
Guts/DicoGIS,a3e794fc98e7386b291e6980fe96ee90c890fdc7,docs/conf.py,0,6,36,33,69
geodynamics/burnman,4742e0b98c7a8a83decb311d41732b870555f539,burnman/minerals/HHPH_2013.py,0,2,3,2,5
couchbase/couchbase-python-client,6d305796b094024c2ea07c8c963899999420f610,couchbase/auth.py,6,1,207,43,250
sde1000/quicktill,13cecf640046e7c701ac1cfbfeb8e6f3c7707494,quicktill/tillweb/admin.py,0,1,1,6,7
meine-stadt-transparent/meine-stadt-transparent,bb943e060cd4ab566663077d623781bf93372794,meine_stadt_transparent/settings/security.py,0,1,1,1,2
python-control/python-control,e2f76df5e6ae2f562a8040ad33f1ea40838994d3,examples/pvtol-nested.py,0,7,29,28,57
pyinvoke/invocations,23ba50c62e87a3327564cf13edc33b0bc7b284b3,invocations/packaging/release.py,0,4,68,1,69
pyinvoke/invocations,797ab03be261e91b6f4de96889044d8274f77bbb,invocations/packaging/release.py,0,3,10,0,10
tensorflow/tensorflow,ba436fd24f918d11a50ab9137d5b6464227cfdc7,tensorflow/python/tpu/tpu_embedding_v2.py,1,1,1,4,5
tensorflow/tensorflow,38999d956103fe500782ae2145caa65764f147ba,tensorflow/python/tpu/tpu_embedding_v2.py,1,1,1,4,5
janeczku/calibre-web,aaa749933d16a57b06309f01ef33962a866e3cc1,cps/search_metadata.py,0,2,4,4,8
cloudify-cosmo/cloudify-cli,82e6a54ba4ab9a87ef6407569e637c432636757c,cloudify_cli/commands/tokens.py,3,1,26,71,97
bsc-dd/hecuba,ec0db7a9cce1209059d432c5b87d452e7a77ddbe,hecuba_py/hecuba/IStorage.py,0,3,8,2,10
catapult-project/catapult,e999681ef89091d15a27b9dc74ae24b799db282a,dashboard/dashboard/pinpoint/models/quest/quest.py,0,2,1,2,3
Tuxemon/Tuxemon,374f047ae21b24d541bc97c2140e564a9ebf90f9,tuxemon/cli/clicommand.py,0,1,1,0,1
jazzband/django-debug-toolbar,a3e8cc0d28850eea7b9ff3073d6f31c256e83a49,debug_toolbar/panels/sql/tracking.py,0,3,25,13,38
pandas-dev/pandas,77d9237d2b9b756374491551551fb4442b53c4de,pandas/core/window/rolling.py,1,4,25,15,40
hazelcast/hazelcast-python-client,497694c43ff4cd7adec7f59769dbf18a5c9eb52d,hazelcast/projection.py,0,4,10,5,15
project-chip/connectedhomeip,2c4fb917fde8b6772097fc508aca055e5d6e9149,src/controller/python/chip/clusters/ClusterObjects.py,2,1,3,9,12
thingsboard/thingsboard-gateway,884305d803e5f4892223517dd7cd4ef96cca5591,thingsboard_gateway/gateway/grpc_service/tb_grpc_manager.py,0,2,6,14,20
thingsboard/thingsboard-gateway,deebadb97084f2cf40ebae28a37241344839f375,thingsboard_gateway/gateway/grpc_service/tb_grpc_manager.py,1,6,9,42,51
reviewboard/ReviewBot,06c5e75f1ef0a9aa268847ccf37699134eb5bc92,bot/reviewbot/repositories.py,7,4,61,175,236
mitmproxy/mitmproxy,b31ad66225050a82b505aaacf75bc30fe31e7f98,examples/contrib/webscanner_helper/urlinjection.py,0,1,1,0,1
cloudtools/troposphere,dce5ab289551d27a0b6dccaebd55e74a58c1de13,troposphere/dynamodb.py,2,5,156,199,355
languitar/autosuspend,0a55a97d471262b9f2cb7943bbdb34753db17533,src/autosuspend/util/systemd.py,0,1,2,0,2
radiasoft/sirepo,ba5d44454f62f22c0520b81311aacde087f87a5d,sirepo/sim_data/raydata.py,1,2,2,5,7
DIRACGrid/WebAppDIRAC,18f34f2cbc7818c78c508888cfbdf4f1836c6e13,src/WebAppDIRAC/WebApp/handler/ProxyUploadHandler.py,0,6,69,45,114
SeleniumHQ/selenium,99fc0e0c8684ecd7e683093605aea09857529340,py/selenium/webdriver/remote/switch_to.py,0,0,0,0,0
SeleniumHQ/selenium,0e24f411f2271388f313be787d771445092b5a71,py/selenium/webdriver/remote/switch_to.py,0,0,0,0,0
SeleniumHQ/selenium,3824c3e9c5bb66b768e5ba2b56e8427e4f4f3c59,py/selenium/webdriver/remote/switch_to.py,0,3,3,3,6
inventree/InvenTree,d49763bd25657cae6bd58f7fb8ba168a23954c27,tasks.py,0,3,5,8,13
reanahub/reana-client,6c357769f12c2d2fe5a0bb98a35cf716cffef623,reana_client/validation/parameters.py,5,1,485,47,532
ray-project/ray,73e113152bcb97c6dec93bc1c2a1d9a98e492a0f,python/ray/autoscaler/_private/aws/node_provider.py,0,2,21,18,39
Tuxemon/Tuxemon,374f047ae21b24d541bc97c2140e564a9ebf90f9,tuxemon/platform/platform_pygame/events.py,0,1,1,0,1
ConSol/omd,5c25b43649054cf5f16e77ba57e0796e16c5c05b,packages/check_plugins/single_files/check_omd.py,1,10,82,83,165
fabioz/Pydev,86af32cce78906d1e5a3abb65d35da4f7a75d487,plugins/org.python.pydev.core/pysrc/_pydevd_bundle/pydevd_json_debug_options.py,0,3,24,4,28
donkirkby/live-py-plugin,342a4ec24c20539dc617511f4daf4abb04f17dc3,plugin/PySrc/space_tracer/live_image.py,0,2,1,1,2
google/glazier,31afd8e2916865adfadc29e3949b586be20cf3e6,glazier/lib/download.py,17,17,34,100,134
ArtifexSoftware/mupdf,e6dad12c0aee5f3282c8d32c2a5d1527d272a325,scripts/mupdfwrap.py,0,26,60,22,82
ArtifexSoftware/mupdf,e4b43b5d05a56810c56be8a99a20e34928b1cf37,scripts/mupdfwrap.py,0,1,2,0,2
txerpa/dj-tximmutability,b0e8c2fbb24d52881fa561fd9f3ac77bf85f3a6b,tximmutability/models.py,4,2,151,40,191
couchbase/couchbase-python-client,d7a0999078748fdf747d83ddd4e730717b36192c,couchbase/bucket.py,2,5,40,135,175
pymedusa/Medusa,6da7bfa9017fe726add1c5ce1450adfa0ac58335,ext/knowit/serializer.py,0,7,38,92,130
pastebt/dwm,f88fccdb0b7a3343f6855cda0858dc236152c520,book.py,0,0,0,0,0
mitmproxy/mitmproxy,b31ad66225050a82b505aaacf75bc30fe31e7f98,mitmproxy/exceptions.py,0,1,1,0,1
ioos/compliance-checker,d21a88b4515b9045fa9e3a680cdafa219ecd8d49,compliance_checker/cf/cf_base.py,0,2,14,0,14
hashview/hashview,598d5f8315496f575a570aa2244ae223eeaaed64,hashview.py,11,3,134,211,345
nilouco/dpAutoRigSystem,c659a9cb7b9e0cee6825e63d30d179dd486a436a,dpAutoRigSystem/Modules/dpLimb.py,0,0,0,0,0
tomerfiliba/plumbum,72e8c1dbac47f93e714ff36f6b50f16f5e0e8571,plumbum/cli/progress.py,0,5,15,13,28
couchbase/couchbase-python-client,6d305796b094024c2ea07c8c963899999420f610,couchbase/encryption/keyring.py,0,0,0,0,0
matrix-org/synapse,b8ad756bd0d7c42c7c241fa08f5e078561fddded,synapse/config/jwt.py,0,0,0,0,0
matrix-org/synapse,50f0e4028b334566a067b671d15246a9b05e8498,synapse/config/jwt.py,0,2,14,3,17
StingraySoftware/stingray,3b1a0738117d74245abbf989087946d12d897c1b,stingray/io.py,0,1,539,0,539
dpressel/baseline,746fcf5fc8ec939094fb4f50939e15eddd7428df,baseline/tf/embeddings.py,0,10,80,14,94
kizniche/Mycodo,2a6d6f62efaa73ac56fc92eecfc71a51857c3368,mycodo/mycodo_flask/utils/utils_export.py,0,1,1,0,1
rdkit/rdkit,a3062a2f816bc8e72a26f922e7bdcaa6fce4da0d,rdkit/Chem/MolDb/Loader_sa.py,0,10,25,16,41
cosven/FeelUOwn,f8a41b61f9de8174ea992b845331870c221e53a0,feeluown/uimodels/playlist.py,0,1,32,5,37
qiniu/python-sdk,af1485cc22f493ae70b7d11ec7725d9b7481b9ce,qiniu/services/storage/uploader.py,0,12,19,33,52
hugsy/gef,bc986cd943e8a37078347166a7603985a56cfff4,gef.py,0,2,5,4,9
hugsy/gef,fcccebe89ddda928a69664970d609ff1cc577158,gef.py,0,1,1,1,2
hugsy/gef,546f4b1824802f176878a41ef2117cf18537188f,gef.py,25,27,363,302,665
catapult-project/catapult,ef16f927e50151533a42c5ecf789c9f75f9f95b3,devil/devil/utils/zip_utils.py,0,1,1,0,1
CCI-Tools/cate-core,730fb91d909b79cccb380e1e79f90c8ff689eb0c,cate/webapi/websocket.py,0,4,2,26,28
wradlib/wradlib,4911a4953d46ed180923d594871432958a60f14c,wradlib/atten.py,0,1,2,0,2
apache/airflow,e1193f2a1a0538897705e4a856d39906c6da9781,airflow/example_dags/example_kubernetes_executor.py,0,2,3,6,9
ray-project/ray,d95009a3ac44a9ee2844964b31fa25f38d083388,rllib/env/multi_agent_env.py,2,4,3,34,37
matrix-org/synapse,63d90f10eccf804a6ca5bfa51cdb1b0d0233fe95,synapse/replication/http/_base.py,0,7,11,20,31
astropy/astropy,b7502d9de9b1063ef85435c604b36340ea6038f9,astropy/table/serialize.py,3,5,20,47,67
apache/cassandra,da47849b50daa0580f2cb4264bcee8a75140eb05,bin/cqlsh.py,0,13,36,12,48
demisto/content,8c6b168dec54d962d8460424fcbfc18b9c4bb6bf,Packs/CortexXDR/Integrations/CortexXDRIR/CortexXDRIR.py,5,12,19,266,285
guardicore/monkey,ee0c98a435ddc4d4c3948b0dde589c83c9b23b29,monkey/infection_monkey/network/tools.py,0,3,90,0,90
psi4/psi4,be533f7f426b6ccc263904e55122899b16663395,psi4/driver/procrouting/diis.py,11,6,75,266,341
matrix-org/synapse,bc9dff1d9597251a15a15475cb8e8194b2d14910,synapse/server.py,0,1,1,0,1
vgrem/Office365-REST-Python-Client,53cc70461c55a8aaa83599c7fb0fdd8437ff9ee0,office365/sharepoint/storagemetrics/storage_metrics.py,4,1,1,39,40
vgrem/Office365-REST-Python-Client,3eaf0cdf730caa356e677a1d2987f29e527eae8a,office365/sharepoint/fields/related_field.py,5,1,1,41,42
pyocd/pyOCD,2bf23039598c179b371fd570b15d4d05529853a4,pyocd/gdbserver/gdbserver.py,0,0,0,0,0
brunosmmm/hdltools,e2b4e4b8217790784d1caad018bf97070c5f087b,usage/sim_stim.py,1,6,14,60,74
candlepin/subscription-manager,d22312a8537dc460e5ba9358ab377bf9940ffb62,src/subscription_manager/repolib.py,0,5,9,12,21
candlepin/subscription-manager,33438f3e44db39725b721520593a311c4da25b92,src/subscription_manager/repolib.py,0,4,12,10,22
coderholic/pyradio,80ced94e2a3336a4894b63dfe6c21f319c3183eb,pyradio/radio.py,3,13,78,182,260
coderholic/pyradio,4c5457129f1e62ccfdeb06c736657b669616969d,pyradio/radio.py,1,7,11,27,38
coderholic/pyradio,288bc67cdb9249ebf1e94c41d068930a0cfc1aad,pyradio/radio.py,0,8,58,29,87
coderholic/pyradio,a4a2cd7f71f65782a5b35ce5178627a23efffb86,pyradio/radio.py,5,21,50,164,214
coderholic/pyradio,700b77b8b677e74ffcca29fab2f3506dc6e79d2b,pyradio/radio.py,24,89,510,1402,1912
coderholic/pyradio,07962f872dfab781193251e6b08c0d7c66a74a22,pyradio/radio.py,1,13,174,182,356
coderholic/pyradio,f73a9c0eb1c92bceb3ef558796978df9cacdbf8d,pyradio/radio.py,0,3,4,1,5
TAMU-CPT/galaxy-tools,8dc151a203ffbf059d134c255698d3f62f3ab284,tools/phage/genome_map.py,0,2,2,2,4
couchbase/perfrunner,46c2ad5b14752748fdcbe8ebc269799003b8440f,perfrunner/utils/install.py,0,1,1,1,2
tomerfiliba/plumbum,72e8c1dbac47f93e714ff36f6b50f16f5e0e8571,plumbum/path/base.py,0,13,38,47,85
ToFuProject/tofu,ab36815866f1480759959fc5ade39f217fa79dc6,tofu/spectro/_fit12d.py,1,0,0,0,0
ToFuProject/tofu,908cdc1cd201beb235a9726b31d69c36d2956479,tofu/spectro/_fit12d.py,2,2,66,157,223
ToFuProject/tofu,048b92198b9037431fae435b0ffb5f4ff9a633e5,tofu/spectro/_fit12d.py,0,1,1,0,1
ToFuProject/tofu,bf547f7ee4c620258e7c48edfb7bb7ed7d54ce6b,tofu/spectro/_fit12d.py,0,13,3370,174,3544
ToFuProject/tofu,9569b3781277ff54e42b092f9165c84aaf692c6d,tofu/spectro/_fit12d.py,0,3,4,2,6
scipy/scipy,fd3f0d41c5b396bf8aa74c61a8236e3830f6e4c2,scipy/stats/_stats_py.py,0,11,21,19,40
scipy/scipy,cefc90760e745bfca5c71f723332a9945b105ee4,scipy/stats/_stats_py.py,0,7,27,104,131
scipy/scipy,ffdd5599bc517dcc1db24aef89bcd5d4fe3f2e31,scipy/stats/_stats_py.py,1,23,107,263,370
scipy/scipy,e2f83b0b1a5635a766bd650af1591823172f25f4,scipy/stats/_stats_py.py,1,24,107,264,371
daniestevez/gr-satellites,07a7dce6bf76cc7dfe94515114a68fff2f23f5b5,docs/doxygen/doxyxml/doxyindex.py,0,0,0,0,0
daniestevez/gr-satellites,2784029876b64b61bc3e43b7badd3f0a0096bea4,docs/doxygen/doxyxml/doxyindex.py,0,11,28,19,47
wikimedia/pywikibot-core,98b85fed7ac3175accebe864d8da9f0122f21e37,pywikibot/exceptions.py,0,1,2,0,2
couchbase/couchbase-python-client,6d305796b094024c2ea07c8c963899999420f610,couchbase/management/eventing.py,0,1,1558,63,1621
docker/docker-py,ea4cefe4fd1e85ef94f477b8e969994117fcb076,docker/transport/sshconn.py,0,1,1,1,2
dask/dask,55195a10c6fa53cc3f5bc50e032b493ceef15b6a,dask/dataframe/io/parquet/core.py,0,4,17,10,27
python-attrs/cattrs,e93b6ec2fcfb8f5af5172a665112e03624905ac8,src/cattr/dispatch.py,0,1,126,2,128
docker/docker-py,ea4cefe4fd1e85ef94f477b8e969994117fcb076,docker/transport/npipeconn.py,0,1,1,1,2
google/flax,09bd6cc84c9adb7adb542c864e3dbd2c343e3b2f,flax/linen/recurrent.py,0,4,6,9,15
rhinstaller/anaconda,683207c921d000cc22cef4a5e6367ebb5dc0a472,pyanaconda/modules/payloads/source/closest_mirror/closest_mirror_interface.py,3,1,3,27,30
Tuxemon/Tuxemon,374f047ae21b24d541bc97c2140e564a9ebf90f9,tuxemon/sprite.py,0,1,1,0,1
CCI-Tools/cate-core,0363a5f80e6f79877ae841ebfc87d7c9dfd3fc64,cate/util/web/webapi.py,1,18,64,78,142
acq4/acq4,ad0648f9cdf7b7c671e51dc2533e04ac612f846f,acq4/devices/Laser/Laser.py,0,1,3,21,24
pytransitions/transitions,0d15c3d9178ba91d1afcf319e07a338a862e15a3,transitions/extensions/factory.py,0,3,32,12,44
matrix-org/synapse,bc9dff1d9597251a15a15475cb8e8194b2d14910,synapse/http/server.py,0,1,1,0,1
catapult-project/catapult,ef16f927e50151533a42c5ecf789c9f75f9f95b3,devil/devil/android/logcat_monitor.py,0,1,1,0,1
apache/cassandra,f28dd90feb215db85ac2e510c5657a49edd46e12,pylib/cqlshlib/copyutil.py,0,2,2,2,4
antoinecarme/pyaf,a40764a63f989d7244ffabbf4984aa59bccefaf0,pyaf/Bench/TS_datasets.py,0,4,87,18,105
vgrem/Office365-REST-Python-Client,8cc8594e6ce49791e94333cc89b03fa0d3f8b6b0,office365/onedrive/permissions/sharing_invitation.py,1,1,1,16,17
mne-tools/mne-python,31a83063557fbd54d898f00f9527ffc547888395,mne/utils/docs.py,0,6,2455,2834,5289
vgrem/Office365-REST-Python-Client,ca5ce2e9219dd4ca41f7e3c1495bd7c33f34a568,office365/sharepoint/audit/audit.py,1,1,1,11,12
couchbase/couchbase-python-client,6d305796b094024c2ea07c8c963899999420f610,couchbase/encryption/decrypter.py,0,0,0,0,0
spulec/moto,10bd677cf2ce642a4820177a0879d86bc5c93451,moto/apigateway/models.py,0,1,4,1,5
docker/docker-py,ea4cefe4fd1e85ef94f477b8e969994117fcb076,docker/auth.py,0,1,1,0,1
rocky/python-uncompyle6,e3c7afb94d51ccee17ae6d054aaed6e67a72f6ed,uncompyle6/semantics/pysource.py,0,2,67,9,76
rocky/python-uncompyle6,f8ae674890f0afb15e1cab14b631af91330d0471,uncompyle6/semantics/pysource.py,0,5,371,2,373
zentralopensource/zentral,a0792e06a3a8674a1eb25f3d206a0f01132594aa,zentral/contrib/jamf/preprocessors/webhook.py,0,1,1,0,1
tomerfiliba/plumbum,72e8c1dbac47f93e714ff36f6b50f16f5e0e8571,plumbum/cli/application.py,0,16,39,39,78
joshcvt/resetter,e0dc6cc9ff4d6e4fc3a713929ffdf77bdf877bca,chalicelib/mlbstatsapi.py,0,6,43,25,68
fabioz/PyDev.Debugger,47e298499ef19563bb2ef5941a57046a35ae6868,_pydevd_bundle/pydevd_json_debug_options.py,0,3,24,4,28
candango/firenado,1cf153c0f84b7541015ca05edefb24167c90a0d5,firenado/launcher.py,0,4,14,3,17
candango/firenado,e2399d2277e6f789c66523849784224f8f1f1f12,firenado/launcher.py,1,5,29,34,63
catapult-project/catapult,ef16f927e50151533a42c5ecf789c9f75f9f95b3,devil/devil/android/device_errors.py,0,3,7,0,7
jsvine/pdfplumber,9587cc7d2292a1eae7a0150ab406f9365944266f,pdfplumber/container.py,5,1,41,116,157
matrix-org/synapse,bc9dff1d9597251a15a15475cb8e8194b2d14910,synapse/storage/databases/main/registration.py,0,1,2,0,2
pantsbuild/pants,3e80b7b07775e87af334e909f7f687366cdd27e0,src/python/pants/jvm/resolve/jvm_tool.py,0,3,53,38,91
jgyates/genmon,5dd744ee1af370778a53858641afeb01c040d91f,ClientInterface.py,0,3,7,3,10
TerryHowe/ansible-modules-hashivault,1ce3eecd04043aac4264fc1e8fc277a15a2c301b,ansible/modules/hashivault/hashivault_db_secret_engine_role.py,0,1,1,0,1
scikit-learn/scikit-learn,0ff613e8dd1e340784d49e2a2308b26eec6c7ff4,examples/manifold/plot_manifold_sphere.py,0,2,9,14,23
CalebBell/thermo,8c6d936fa88316300c2f14ac2e3ca4f67e73a2c7,thermo/phases/ceos.py,40,2,64,268,332
CalebBell/thermo,d35c863dbffa1561e426f11199bd32762db9d4c7,thermo/phases/ceos.py,0,11,11,0,11
matthiaskoenig/sbmlutils,ffc2158b10e188fbd471017a64776329e5e5e4e1,src/sbmlutils/report/sbmlreport.py,0,3,17,0,17
catapult-project/catapult,e999681ef89091d15a27b9dc74ae24b799db282a,dashboard/dashboard/pinpoint/models/scheduler.py,0,2,1,2,3
sqlalchemy/sqlalchemy,ec3e6c7dc2c03849b140c17e17e1efdc2f932a4a,lib/sqlalchemy/orm/attributes.py,1,1,1,1,2
sqlalchemy/sqlalchemy,af4285e6adf2a052ce985f9d3d97cc89778fca96,lib/sqlalchemy/orm/attributes.py,1,2,5,2,7
sqlalchemy/sqlalchemy,1fa3e2e3814b4d28deca7426bb3f36e7fb515496,lib/sqlalchemy/orm/attributes.py,18,89,239,686,925
couchbase/couchbase-python-client,fa73c250546fe61bf593b5e3917d389384345ad1,couchbase/collection.py,0,22,73,76,149
couchbase/couchbase-python-client,d7a0999078748fdf747d83ddd4e730717b36192c,couchbase/collection.py,20,43,643,1291,1934
hankcs/HanLP,7f241465b9bd4927e2ec93ede8a4434f9a182dbc,plugins/hanlp_common/hanlp_common/constant.py,0,1,6,8,14
matrix-org/synapse,bc9dff1d9597251a15a15475cb8e8194b2d14910,synapse/rest/media/v1/_base.py,0,1,1,0,1
catapult-project/catapult,3a12d6ccdec28da8bda09d9ff826aae1f9504e59,third_party/gsutil/third_party/rsa/rsa/common.py,3,5,42,42,84
matrix-org/synapse,bc9dff1d9597251a15a15475cb8e8194b2d14910,synapse/util/caches/treecache.py,0,1,2,0,2
DIRACGrid/WebAppDIRAC,3d54ba26574f6b68736aa1a6a1a9188e8524102f,src/WebAppDIRAC/WebApp/handler/JobMonitorHandler.py,0,14,244,145,389
pytransitions/transitions,0d15c3d9178ba91d1afcf319e07a338a862e15a3,transitions/extensions/locking.py,0,7,15,9,24
wikimedia/pywikibot-core,98b85fed7ac3175accebe864d8da9f0122f21e37,pywikibot/site/_obsoletesites.py,0,1,2,0,2
analyst-collective/dbt,1c634af489a11f9f09ba3758b21e2726883d401d,core/dbt/context/providers.py,0,2,3,14,17
quodlibet/quodlibet,0cd37f779b0a8c9caf1f7d42041c7715e2a63fd6,quodlibet/util/misc.py,0,1,4,1,5
colour-science/colour,3db92346a8f9b81675568498070c22153db356f1,utilities/export_todo.py,0,3,3,2,5
apache/spark,0e875875059c1cbf36de49205a4ce8dbc483d9d1,python/pyspark/ml/evaluation.py,0,1,2,0,2
radiasoft/sirepo,b89aa205cdb60cd77ccb6fff90ece8244b0a9b90,sirepo/srtime.py,0,4,13,9,22
openstack/tacker,158f05e4734904872fd7378c1bd5f43fe3aa05d9,tacker/sol_refactored/controller/vnflcm_view.py,1,3,1,11,12
ioos/compliance-checker,d21a88b4515b9045fa9e3a680cdafa219ecd8d49,compliance_checker/base.py,0,2,2,0,2
hail-is/hail,8b52dc4dde6e84a1cc086785a5f289a611c7c4da,hail/python/hail/ir/blockmatrix_ir.py,4,15,40,79,119
protwis/protwis,8efa811effd3bae894c185c1642d15ed2c0e5015,ligand/views.py,0,4,26,20,46
protwis/protwis,855001af8a4c7ba60eb5a0937697b1158997ae6b,ligand/views.py,3,5,3,8,11
protwis/protwis,6e4af51a51d478cdfb807c252bf431141a4ce229,ligand/views.py,0,9,1011,168,1179
protwis/protwis,ca09de0eed6642e69c636a136b5510c668343d82,ligand/views.py,3,9,9,23,32
protwis/protwis,7639bc415b6c40977ecca514b1c51ffca7d38d2f,ligand/views.py,0,5,10,22,32
protwis/protwis,068efd3546fbab27aa3ab9c231f7c33a32caec5a,ligand/views.py,0,4,4,23,27
radiasoft/pykern,5324e9ca761a88003a1f618e641152b32c6ea654,pykern/pkcompat.py,0,1,25,0,25
radiasoft/pykern,e1a092898389436513f3525d405c4ce403064626,pykern/pkcompat.py,2,4,61,56,117
zentralopensource/zentral,6856f4d5a7dbf7522db3c317f76d0ae481c16f9f,zentral/core/events/base.py,0,1,1,0,1
vgrem/Office365-REST-Python-Client,c5249fe97a8062694e86f4e6ced1615b3fe5a164,office365/onedrive/driveitems/thumbnail.py,1,1,1,15,16
ibis-project/ibis,1e69defd7a79df36599b1a78a4d772e348a9cf66,ibis/config.py,0,0,0,0,0
openego/eDisGo,b74e439777a3dc74e0594448735a5fa2299e79fd,edisgo/network/components.py,3,9,236,44,280
matrix-org/synapse,bc9dff1d9597251a15a15475cb8e8194b2d14910,synapse/storage/schema/main/delta/30/as_users.py,0,1,1,0,1
luci/luci-py,679738de8578b6dd98243e25ed1e7ad9b9995f9d,appengine/swarming/server/task_queues.py,0,1,1,0,1
scikit-learn/scikit-learn,bc44ea7ae849f533c3df6811b410f46d61998dff,examples/manifold/plot_compare_methods.py,3,1,53,169,222
scikit-learn/scikit-learn,02087e13084e95e17c26cd35b6152e0c833e6052,sklearn/cross_decomposition/_pls.py,1,10,206,47,253
isard-vdi/isard,b65eeb267bdb129ff49687016e6eb7b9c01d0d51,api/src/api/libv2/api_socketio_domains.py,0,3,12,15,27
CenterForOpenScience/osf.io,824c00990ad79273d8fb94869e34b0fe5304719b,osf/models/sanctions.py,0,8,33,0,33
CenterForOpenScience/osf.io,1bbc970a586f0e26c3a00f4a4c5370aaee88ee3d,osf/models/sanctions.py,0,2,0,5,5
CenterForOpenScience/osf.io,4486c60efbbca282c4393d0b5197166310706871,osf/models/sanctions.py,0,1,15,0,15
CenterForOpenScience/osf.io,0ad3aad7504d110a4de25053db95331229e49078,osf/models/sanctions.py,3,5,38,6,44
CenterForOpenScience/osf.io,a30cf0fa03d5a7e03142cb26a3d96663e16e1546,osf/models/sanctions.py,0,2,68,0,68
pcolmant/repanier,5dc8882764d50b8f7d3650d848cb746a54297942,repanier/xlsx/xlsx_purchase.py,0,0,0,0,0
pcolmant/repanier,578a066df4232933b285a6290e068faeb56fd4b9,repanier/xlsx/xlsx_purchase.py,0,1,5,0,5
scylladb/scylla,c2ccdac2975bcb841db96e7165a93e0b0f481b19,dist/common/scripts/scylla_util.py,1,4,673,9,682
Keeper-Security/Commander,7cd4c4e4fbfba0d22ec53e7df55ca8623d076192,keepercommander/commands/record.py,2,2,1521,89,1610
Azure/azure-sdk-for-python,663c846e4d24166f0e76092a80989cfd08521bf2,sdk/sql/azure-mgmt-sql/azure/mgmt/sql/operations/_databases_operations.py,0,79,747,1120,1867
DStauffman/dstauffman,5344f6ed74637d17ef9a9bdd74410eca671cb376,dstauffman/plotting/generic.py,0,8,24,20,44
saltstack/salt,2ff4835ff305af47c678344a14ad75bc63831a4d,noxfile.py,0,1,121,0,121
ray-project/ray,b51d0aa8b12ceb7ce082b69db4d2707ea52c0b69,python/ray/serve/api.py,0,14,706,55,761
acq4/acq4,78f4ef7e6c02a277fd4b7ee1da2098b6c18f8f9f,acq4/util/LogWindow.py,0,32,284,102,386
BruceDLong/CodeDog,30f96ea9bb48aedcb700cc573b99f300e0dd86d6,xlator_Swift.py,0,7,50,16,66
BruceDLong/CodeDog,e674a70c09d735d1cceeb26d18df1fc9aef4ca6a,xlator_Swift.py,71,1,1012,954,1966
BruceDLong/CodeDog,15918cf8360e850106b84f51c2dc1d44983ec300,xlator_Swift.py,2,23,337,290,627
kizniche/Mycodo,23974f1380dc95ea9721aea86c3ac71addcce65e,mycodo/controllers/controller_pid.py,1,28,301,138,439
kizniche/Mycodo,981170f380b438405238f6dfc4f079f7e588340f,mycodo/controllers/controller_pid.py,0,22,134,86,220
Azure/azure-sdk-for-python,13137cd5c59b3cb8277bfe285c7f1242ccc575a6,sdk/synapse/azure-mgmt-synapse/azure/mgmt/synapse/operations/_sql_pools_operations.py,0,62,119,206,325
wradlib/wradlib,bacc4f0e813b28b467b1f383cc1f244e915a0209,wradlib/zonalstats.py,0,7,388,15,403
libAtoms/matscipy,2666b041bdf91b6869aa4cfcfe012d546cb12aee,matscipy/calculators/ewald/calculator.py,12,19,766,229,995
ccxt/ccxt,9295a68f4b1f4b217feb1cf60a3eca78b5ba394b,python/ccxt/gateio.py,0,1,4109,3,4112
tzpBingo/github-trending,51b1a12ac70466998efb6d05e860f9a22c01f1f9,codespace/python/tencentcloud/taf/v20200210/models.py,0,6,250,4,254
metabrainz/listenbrainz-server,359ff0af11f58ffef10d99513408acfd4887d2d8,listenbrainz/listenstore/timescale_listenstore.py,0,7,61,34,95
metabrainz/listenbrainz-server,21aa3b063e2aa785e360993e4858cc524455fdc6,listenbrainz/listenstore/timescale_listenstore.py,0,8,84,19,103
metabrainz/listenbrainz-server,9edfbdad09af6c04d4a2025b0a384c51591a0a3b,listenbrainz/listenstore/timescale_listenstore.py,1,5,499,22,521
pcolmant/repanier,5dc8882764d50b8f7d3650d848cb746a54297942,repanier/models/invoice.py,0,0,0,0,0
pcolmant/repanier,127d5ecd3f6620309cbae5c7f34669c265c19ab3,repanier/models/invoice.py,0,12,190,43,233
spectralDNS/shenfun,513ccc060635641d9cd5b40c5bb48a4b9a2c9387,shenfun/legendre/matrices.py,0,39,165,100,265
StingraySoftware/stingray,29cb4331cb4a5429838f3c56b504ff03bd6f1d73,stingray/io.py,0,9,234,54,288
StingraySoftware/stingray,4ad321a1acfa61f30c17bdaba7595e40e493cd81,stingray/io.py,0,1,4,2,6
StingraySoftware/stingray,5e6826deadbd0a21c88862a64c0b6b09c9826839,stingray/io.py,0,5,117,11,128
StingraySoftware/stingray,fe19d1a1bf556ac9eb3a8a771461d3688530d649,stingray/io.py,0,6,116,36,152
rhinstaller/anaconda,0d2a9964c8cbbd486629dbc8da65d10e482e3839,pyanaconda/payload/dnf/payload.py,0,5,79,12,91
mlflow/mlflow,1e2b4ed051bc760fd3e7d69149e1fbc1f7928edf,mlflow/protos/model_registry_pb2.py,0,2,2140,448,2588
simpeg/discretize,77aaa60556136675a5356db3965f26a7b9baa35c,discretize/operators/inner_products.py,0,5,720,0,720
cclib/cclib,504c482ed48c14e191f6fad5b72b00b4a61e061d,cclib/parser/molcasparser.py,0,5,24,14,38
google/jax,20f9230f6e14d6f634a9a02b1185d6bb687905f2,jax/interpreters/xla.py,0,6,50,38,88
google/jax,c52f32b59d5c9d9d4d221ecaf520f9eb5cbaefd2,jax/interpreters/xla.py,0,2,4,2,6
google/jax,a48752a5786e5debda219cfaccb8aa694266e6d5,jax/interpreters/xla.py,1,10,196,27,223
Azure/azure-sdk-for-python,f860b5dadfd762669043059226c475a92f584514,sdk/netapp/azure-mgmt-netapp/azure/mgmt/netapp/operations/_volumes_operations.py,14,102,292,1137,1429
kizniche/Mycodo,5055e1d42a3cf60e40ae3fa2c013591a3a48bb02,mycodo/config.py,0,11,79,57,136
kizniche/Mycodo,4e2856128998cf3c783863f61e81a35574254be7,mycodo/config.py,0,3,262,3,265
qtile/qtile,5ca523c5fac7737c70c5f652e3b4492b40f30102,libqtile/backend/wayland/window.py,0,4,165,2,167
qtile/qtile,e479d232606eed3ecf653df25db27ea531d4015f,libqtile/backend/wayland/window.py,0,1,6,1,7
voxpupuli/puppetboard,54fb258b0694d30770dec51b1833507fc82eb218,puppetboard/app.py,0,1,53,0,53
voxpupuli/puppetboard,2af188fb2d5167d62b92f2e2161042b3697256a1,puppetboard/app.py,0,2,82,2,84
isard-vdi/isard,4c6512fb3c807a8871e80fd009479d6cced12b7b,api/src/api/views/AdminUsersView.py,0,11,449,94,543
isard-vdi/isard,5ff48dc9fc65e11f72874753632dfd678d936f78,api/src/api/views/AdminUsersView.py,2,6,58,21,79
tzpBingo/github-trending,9f2184dd7c8717fbb6a8153ecc444a0b05434511,codespace/python/tencentcloud/cat/v20180409/cat_client.py,0,6,797,14,811
tensorflow/federated,306cc573c63c5225eb04cccc761df05fa7bdfaf3,tensorflow_federated/python/core/impl/compiler/tree_transformations.py,0,3,581,1,582
openstack/kolla,af648f40a9f5ad72365c4bc84ac363c7f9e70220,kolla/common/config.py,0,2,683,2,685
numba/numba,8d38cd594429bf5c46df5df783ea31d92140982c,numba/cuda/compiler.py,37,21,155,177,332
numba/numba,28b8b71467a4a66baf101c49510cd1a4d2b5e923,numba/cuda/compiler.py,0,2,511,4,515
ccxt/ccxt,893d66a6e56a5161115c85a3dc103347ffea6da9,python/ccxt/currencycom.py,0,3,20,1,21
ccxt/ccxt,9f17bb7dcae7c0b3fba7c71f581b774013111153,python/ccxt/currencycom.py,0,5,10,6,16
Azure/azure-sdk-for-python,663c846e4d24166f0e76092a80989cfd08521bf2,sdk/sql/azure-mgmt-sql/azure/mgmt/sql/aio/operations/_databases_operations.py,0,60,512,862,1374
Azure/azure-sdk-for-python,6d221527f2263f7a989b82abc8ca040c45e13f11,sdk/logic/azure-mgmt-logic/azure/mgmt/logic/operations/_workflows_operations.py,15,26,523,1111,1634
google/starthinker,bc7eeb87eddab30b193dc7be3457d117d10c978f,starthinker/task/itp_audit/queries.py,0,7,699,1,700
ccxt/ccxt,893d66a6e56a5161115c85a3dc103347ffea6da9,python/ccxt/async_support/currencycom.py,0,3,20,1,21
ccxt/ccxt,9f17bb7dcae7c0b3fba7c71f581b774013111153,python/ccxt/async_support/currencycom.py,0,5,10,6,16
PanDAWMS/panda-bigmon-core,2a588ecd38574bab7942a16fcce19d175b0ed2e6,core/libs/task.py,0,6,378,3,381
PanDAWMS/panda-bigmon-core,6760be55efa1c62d703c3f7e4f3a174c704e0eb5,core/libs/task.py,1,7,62,59,121
couchbase/couchbase-python-client,15fef00b90952a689dbaf0d2045ede11d50e43c5,couchbase/cluster.py,2,5,82,27,109
couchbase/couchbase-python-client,6d305796b094024c2ea07c8c963899999420f610,couchbase/cluster.py,6,2,1194,188,1382
mlflow/mlflow,1e2b4ed051bc760fd3e7d69149e1fbc1f7928edf,mlflow/protos/service_pb2.py,0,3,2686,523,3209
Azure/azure-sdk-for-python,663c846e4d24166f0e76092a80989cfd08521bf2,sdk/sql/azure-mgmt-sql/azure/mgmt/sql/operations/_sync_groups_operations.py,0,82,251,487,738
minus34/gnaf-loader,80a9f46815c0bcaa889eff745b41793757536c72,load-gnaf.py,0,19,211,52,263
minus34/gnaf-loader,70de64f4d4042049ae435328c536c7dd5d377db5,load-gnaf.py,0,3,158,13,171
minus34/gnaf-loader,21535653aada61dde6976db0438f462a7715d4ae,load-gnaf.py,0,3,4,3,7
Azure/azure-sdk-for-python,3a56459f806388f67d367c5cd1e8896143aeff11,sdk/media/azure-mgmt-media/azure/mgmt/media/operations/_live_events_operations.py,0,67,258,461,719
ligo-cbc/pycbc,11142c548ee91c37c8819a2f5e81b65f78eac873,pycbc/workflow/segment.py,0,3,1143,63,1206
kizniche/Mycodo,8c5f7b3df0276ab841e7d1103b5693631ccb72f5,mycodo/mycodo_flask/routes_general.py,0,6,396,38,434
WeblateOrg/weblate,1f839cc7d4950bf08bfe3b1ecfd875314c71081a,weblate/trans/templatetags/translations.py,0,2,28,0,28
openego/eDisGo,08d372163993d57622dc7911d926674b706024d6,edisgo/io/pypsa_io.py,0,3,119,0,119
FCP-INDI/C-PAC,6fc1885156b51c59258ecea2a997d9eaad3e9a91,CPAC/pipeline/schema.py,0,3,5,10,15
ray-project/ray,e0a63f770f9afd6eda2d4da9bf508067429585ae,python/ray/data/extensions/tensor_extension.py,0,1,1373,8,1381
DStauffman/dstauffman,5344f6ed74637d17ef9a9bdd74410eca671cb376,dstauffman/plotting/support.py,0,13,20,20,40
tensorflow/federated,a0aa76ba268b3586a870e9bb93efe7d763881206,tensorflow_federated/python/core/impl/compiler/transformations.py,0,1,48,0,48
matrix-org/synapse,bc29a19731c518dbd70f3adefc66061fb4629cee,synapse/config/server.py,0,1,1,1,2
matrix-org/synapse,3916e1b97a1ffc481dfdf66f7da58201a52140a9,synapse/config/server.py,0,2,3,3,6
matrix-org/synapse,493c2fc44abcf3457953cc2f6f23509ff7855253,synapse/config/server.py,0,4,492,2,494
matrix-org/synapse,271cb1998bab21a3c2a62f72d3179c6af835ad70,synapse/federation/transport/client.py,0,1,1,1,2
matrix-org/synapse,32e7c9e7f20b57dd081023ac42d6931a8da9b3a3,synapse/federation/transport/client.py,0,49,160,134,294
matrix-org/synapse,1ba359a11f238fa8d9b6319067d1b0acefdba20a,synapse/federation/transport/client.py,0,1,11,0,11
matrix-org/synapse,bc29a19731c518dbd70f3adefc66061fb4629cee,synapse/federation/transport/client.py,2,6,34,5,39
matrix-org/synapse,e519489fc43865a0a01e2295782389e322ba5100,synapse/federation/transport/client.py,0,1,24,0,24
matrix-org/synapse,d9f092285b28f0cdac0d985813a1cabd8ea990b6,synapse/federation/transport/client.py,0,2,483,0,483
mittagessen/kraken,b2d9719d09b23c22c3101a8b0e929168e1504e8d,kraken/lib/train.py,0,2,25,11,36
Azure/azure-sdk-for-python,f860b5dadfd762669043059226c475a92f584514,sdk/netapp/azure-mgmt-netapp/azure/mgmt/netapp/operations/_backups_operations.py,0,52,102,158,260
IfcOpenShell/IfcOpenShell,bab63133135adadd654eb09c9d70675d15a127b9,src/ifcopenshell-python/ifcopenshell/express/express_parser.py,0,7,1315,308,1623
PMEAL/OpenPNM,da94249c2974d8f30cdd1fdcc23f72ba1c5c4f89,openpnm/utils/_project.py,0,9,870,7,877
DStauffman/dstauffman,18fce447abd70fa722385b5b44def325b56ad195,dstauffman/plotting/aerospace.py,0,9,330,37,367
DStauffman/dstauffman,5344f6ed74637d17ef9a9bdd74410eca671cb376,dstauffman/plotting/aerospace.py,0,14,14,18,32
DStauffman/dstauffman,5344f6ed74637d17ef9a9bdd74410eca671cb376,dstauffman/aerospace/quat.py,0,13,24,23,47
ioos/compliance-checker,a951b39b84277a1e60c0dd33c235151333412954,compliance_checker/suite.py,0,1,2,0,2
ioos/compliance-checker,3560c9fba7df3673b9fbea8ed39f38719731caaa,compliance_checker/suite.py,0,10,55,14,69
ioos/compliance-checker,a37a961abf2bfb4b9c27b255ef7cb53cdc4148d3,compliance_checker/suite.py,0,3,3,0,3
ioos/compliance-checker,74b13c0ae7a2d72d4be67420fc75e445219ce428,compliance_checker/suite.py,0,1,6,3,9
Azure/azure-sdk-for-python,663c846e4d24166f0e76092a80989cfd08521bf2,sdk/sql/azure-mgmt-sql/azure/mgmt/sql/aio/operations/_sync_groups_operations.py,0,64,133,353,486
matrix-org/synapse,7754af24ab163a3666bc04c7df409e59ace0d763,synapse/handlers/room_summary.py,0,14,312,11,323
StingraySoftware/stingray,8197c4ce067b54a41e4e90181091443000b2dfd9,stingray/events.py,0,7,182,11,193
googlefonts/gftools,f7d1fb9edaad69d054906dfb33087aca38271af1,Lib/gftools/fonts_public_pb2.py,0,13,433,106,539
googlefonts/gftools,5422a1c317668dfad7d150b4eded9b27cc7cac15,Lib/gftools/fonts_public_pb2.py,0,4,992,53,1045
espressif/esptool,a1b567adfcb8f5557850c3300174e5ef9ae418bd,esptool.py,1,14,13,53,66
spulec/moto,29d01c35bc06d5a8462487d614e33b9e8416ba96,moto/logs/models.py,0,3,9,3,12
influxdb/kapacitor,c38245a5d7a356baf426efe254ebff3cd937258f,build.py,0,14,45,19,64
influxdb/kapacitor,e5b44d000b751a9dcfdbd15e8403047e4ee9b659,build.py,0,1,16,5,21
BruceDLong/CodeDog,1c2ad8c48461f86bc3e91fe7dea81e5d6228e107,xlator_Java.py,0,10,131,24,155
BruceDLong/CodeDog,2fa011b95a9a34e5edc7f13efe77151172e8df69,xlator_Java.py,0,2,35,4,39
OstapHEP/ostap,f308e47b53a69915c706b43f175c27d9ecccac2a,ostap/math/derivative.py,5,17,606,224,830
BruceDLong/CodeDog,df78a249d57b5acef001b9a14e7c73f6da9683ac,xlator_CPP.py,0,6,15,11,26
BruceDLong/CodeDog,1d2548bb0e76e0953ce0164ce6181fb2e3ba8f05,xlator_CPP.py,0,1,2,0,2
pandas-dev/pandas,9dc9d805fe58cf32a8a3c8ab2277517eaf73d4c6,pandas/core/reshape/reshape.py,0,4,373,0,373
pandas-dev/pandas,dfb1b84e1c6cc840f18b118df142e7df2c67d24f,pandas/core/reshape/reshape.py,0,1,91,0,91
pandas-dev/pandas,32d341254253a9201fa5990b0e7ef77be38be1fb,pandas/core/reshape/reshape.py,0,3,307,1,308
catalyst-cooperative/pudl,67ee8b087a1504f6d3fc3123f5e645b4073d0920,src/pudl/extract/ferc1.py,0,1,243,0,243
catalyst-cooperative/pudl,67ae683e24e433e2fcac8a711f0fac5804ca25d8,src/pudl/extract/ferc1.py,0,26,182,136,318
catalyst-cooperative/pudl,95ffa2ebf408569da721cc461523aea3d531250c,src/pudl/extract/ferc1.py,0,1,119,1,120
catalyst-cooperative/pudl,faa3efc1ebe379552c231c91942e086edb43484b,src/pudl/extract/ferc1.py,0,3,4,3,7
catalyst-cooperative/pudl,47a606b1c4ac99e762b71b9849edf2bcb1056f27,src/pudl/extract/ferc1.py,8,8,204,194,398
catalyst-cooperative/pudl,0740e04a4d86cab3c7b5bd530f2f04ed324e2df1,src/pudl/extract/ferc1.py,2,6,301,73,374
catalyst-cooperative/pudl,f28b5b5edf35198f009a0a255bffacfd3c3f14a4,src/pudl/extract/ferc1.py,12,20,345,324,669
catalyst-cooperative/pudl,7bf50c043abf4b16ec005c35f3d9f6f33d4bdaf0,src/pudl/extract/ferc1.py,6,19,423,233,656
catalyst-cooperative/pudl,43c7f32379f1e6a3167249f8ca903651c4444c27,src/pudl/extract/ferc1.py,0,1,0,8,8
catalyst-cooperative/pudl,0c02ff228e8d798a046598e3fdaba6c09f024326,src/pudl/extract/ferc1.py,0,7,46,164,210
catalyst-cooperative/pudl,adefcd94823e1313bb44e4a83e49325893efaf95,src/pudl/extract/ferc1.py,2,11,360,160,520
catalyst-cooperative/pudl,8bfc22c298874a114cb4343e3d67a07ec3785bd3,src/pudl/extract/ferc1.py,0,3,308,2,310
ccxt/ccxt,9295a68f4b1f4b217feb1cf60a3eca78b5ba394b,python/ccxt/async_support/gateio.py,0,1,4109,3,4112
gajim/gajim,655d41cf2a5f553a9977284d01f85e64c6c1606b,gajim/gtk/start_chat.py,2,8,41,23,64
gajim/gajim,65c22279bae34bb7161aed8b9172fc7e3d835da4,gajim/gtk/start_chat.py,0,2,10,2,12
ctools/ctools,d72c13e649476d06e9d9916a5c17da71a80c28c1,cscripts/csscs.py,1,2,7,3,10
ibis-project/ibis,0d27b7e535ec8b44b9f89a2d962784b743c8a626,ibis/expr/api.py,0,0,0,0,0
google/uncertainty-baselines,638b945001431b64963685b5cc073f8f0c258073,baselines/toxic_comments/sngp.py,0,2,71,24,95
google/uncertainty-baselines,f0060cd2be7ef63f4bb44674d5ab3575e170003e,baselines/toxic_comments/sngp.py,0,4,99,5,104
openego/eDisGo,f02f20b75883f3caaa5a9db165f422ec24aa5b47,edisgo/network/components.py,0,2,182,0,182
Kozea/WeasyPrint,d02bc1bde113cb07d930b94accb618cbd9f960b7,weasyprint/document.py,0,6,193,112,305
Kozea/WeasyPrint,d4b7f242c3c5c07ac2ee5ab524e48fc4c13b0f72,weasyprint/document.py,0,1,2,1,3
Kozea/WeasyPrint,24c81ad99e39dbb730c327cfe00f172eca806e2a,weasyprint/document.py,0,5,65,12,77
Kozea/WeasyPrint,cd5f1784091bb7b37262b38f40aca70f96852c3d,weasyprint/document.py,0,3,29,5,34
BirkbeckCTP/janeway,45e2eef5f5b9c3b6ae6ba7a64510fd65709da576,src/press/views.py,0,2,2,6,8
BirkbeckCTP/janeway,27246611bcf7ae0399ae526e5be3ecf335c85739,src/press/views.py,0,1,1,1,2
BirkbeckCTP/janeway,1aa5e3bf91927b11bf6dd30c858aabc87b93e567,src/press/views.py,1,4,9,12,21
frappe/erpnext,494bd9ef78313436f0424b918f200dab8fc7c20b,erpnext/patches/v11_0/rename_production_order_to_work_order.py,0,1,11,17,28
mitmproxy/mitmproxy,b3587b52b25077f68116b9852b041d33e7fc6601,mitmproxy/utils/sliding_window.py,0,2,6,8,14
jeremiah-c-leary/vhdl-style-guide,ad87ea65ee434bed3e643cfc78ded2c0ec174dfe,vsg/rules/port/rule_008.py,0,1,1,1,2
frappe/erpnext,494bd9ef78313436f0424b918f200dab8fc7c20b,erpnext/startup/leaderboard.py,0,8,73,107,180
jumpserver/jumpserver,44ffd099244a3a9de7b6c4dad7d06c88b2624cf8,apps/common/utils/crypto.py,0,3,4,11,15
Flexget/Flexget,f19fe92b4826a1dc20e25d22aa6c9b4363902276,flexget/components/status/db.py,0,5,9,9,18
Flexget/Flexget,8d287b0f3413953eb0065955f080bd300d2d98fe,flexget/components/status/db.py,0,1,1,1,2
jeremiah-c-leary/vhdl-style-guide,ad87ea65ee434bed3e643cfc78ded2c0ec174dfe,vsg/rules/attribute_specification/rule_503.py,0,1,1,1,2
jeremiah-c-leary/vhdl-style-guide,c203f3bc64b77dccedbc339a2c7805ea5db5cc9d,vsg/rules/port/rule_020.py,0,3,4,6,10
hyperspy/hyperspy,ca5a381f2d7bc8382fea9bbe0b17f9e9ddd5adc2,hyperspy/misc/utils.py,0,4,10,14,24
hyperspy/hyperspy,b3fadbe7f2b52fdfd2ebf1b9e6d330fbd230db31,hyperspy/misc/utils.py,1,1,0,5,5
hyperspy/hyperspy,0ff8f4069934ee7f8559b5d9597a2ca641790a3f,hyperspy/misc/utils.py,1,17,42,41,83
hyperspy/hyperspy,bea5c3ac358d4a1709ab154ad44788ee91a6312a,hyperspy/misc/utils.py,2,13,71,109,180
hyperspy/hyperspy,5fe6fa4e59f4e0c966324ff197c3dde8e3805434,hyperspy/misc/utils.py,2,14,69,79,148
hyperspy/hyperspy,501a8f58db2ded6888b2ee9466d5b2a388486f9f,hyperspy/misc/utils.py,0,44,203,238,441
hyperspy/hyperspy,b24fbfde0a0696349c0f26afcb590afbf688c78b,hyperspy/misc/utils.py,2,41,215,352,567
hyperspy/hyperspy,3f3477416bd3d8605447549d77e9a073f4c83b90,hyperspy/misc/utils.py,7,46,324,527,851
pcolmant/repanier,5dc8882764d50b8f7d3650d848cb746a54297942,repanier/admin/group.py,0,0,0,0,0
pcolmant/repanier,578a066df4232933b285a6290e068faeb56fd4b9,repanier/admin/group.py,0,2,3,1,4
fabioz/Pydev,89c9e747e052957de792eef2127b6574db1aa2be,plugins/org.python.pydev.core/pysrc/_pydev_bundle/_pydev_calltip_util.py,0,3,8,5,13
DemocracyClub/UK-Polling-Stations,77054217cc1ee7c2130f2649738c8bf88fdd48ca,polling_stations/apps/data_importers/management/commands/import_southwark.py,0,1,41,16,57
miraheze/puppet,ae7114426af8bc30d23066f02b103a4490067f7e,modules/irc/files/logbot/adminlog.py,0,1,2,8,10
frappe/erpnext,2fa2f7178d122fa3299b13ed0f2bb93e4fe7d6d5,erpnext/buying/doctype/supplier/supplier.py,0,0,0,0,0
frappe/erpnext,83f4780f749f83c155f2610ce6c0180d8427e122,erpnext/buying/doctype/supplier/supplier.py,0,1,8,0,8
frappe/erpnext,494bd9ef78313436f0424b918f200dab8fc7c20b,erpnext/buying/doctype/supplier/supplier.py,0,8,28,42,70
pydoit/doit,87e923a7dfb7e9c2fcbec8297afd915e2641266c,doit/cmdparse.py,0,6,14,17,31
pypa/virtualenv,b85542c31ca8afcff317e618da434f59fa06d122,src/virtualenv/report.py,0,3,9,5,14
jeremiah-c-leary/vhdl-style-guide,ad87ea65ee434bed3e643cfc78ded2c0ec174dfe,vsg/rules/package_body/rule_502.py,0,1,1,1,2
jeremiah-c-leary/vhdl-style-guide,c203f3bc64b77dccedbc339a2c7805ea5db5cc9d,vsg/rules/entity/rule_002.py,0,2,4,7,11
frappe/erpnext,494bd9ef78313436f0424b918f200dab8fc7c20b,erpnext/stock/valuation.py,0,9,21,25,46
mrachinskiy/jewelcraft,67c9a2063152125db8835717292a399fd94d8d0c,op_design_report/report_warn.py,0,2,12,0,12
Catch-up-TV-and-More/plugin.video.catchuptvandmore,5e1ca6eb7afe06ccc1a17cf2c7f5cec495a9a391,resources/lib/channels/wo/nhkworld.py,0,0,0,0,0
Catch-up-TV-and-More/plugin.video.catchuptvandmore,80530ff09725860038067af8fc4cc73872224cfc,resources/lib/channels/wo/nhkworld.py,0,3,8,14,22
jeremiah-c-leary/vhdl-style-guide,ad87ea65ee434bed3e643cfc78ded2c0ec174dfe,vsg/rules/attribute_specification/rule_502.py,0,1,1,1,2
jeremiah-c-leary/vhdl-style-guide,fdf02d5523b537058eb599f3eb7ac0a43e2a2b3f,vsg/rules/component/rule_008.py,0,1,9,11,20
jeremiah-c-leary/vhdl-style-guide,ad87ea65ee434bed3e643cfc78ded2c0ec174dfe,vsg/rules/component/rule_008.py,0,1,1,1,2
jeremiah-c-leary/vhdl-style-guide,c203f3bc64b77dccedbc339a2c7805ea5db5cc9d,vsg/rules/component/rule_002.py,0,2,4,7,11
asottile/reorder_python_imports,214df23bcf72a059cfc195db901651c7dbaa34aa,reorder_python_imports.py,0,2,3,7,10
envoyproxy/envoy,00b5ea5fdca91697a051754d0ce46be024badca9,tools/protodoc/generate_empty.py,0,2,18,4,22
vslavik/poedit,e261ac74a7ad90ba1caef8e069ba2176ca92206f,scripts/extract-plural-forms.py,0,2,3,7,10
astrobin/astrobin,d099eb1f682293f8a2570fef0c14fc1534f4a625,astrobin_apps_images/api/permissions/has_uncompressed_source_uploader_access_or_read_only.py,0,2,2,5,7
jeremiah-c-leary/vhdl-style-guide,a820c8a30f36c3a6dfe40245047e2c789de75711,vsg/rules/procedure/rule_200.py,0,1,1,1,2
pantsbuild/pants,fadfb5b731224b191e7f060cce52f21bcbec30fd,src/python/pants/backend/docker/goals/package_image.py,0,2,22,24,46
StellarCN/py-stellar-base,6850e0fec38a7c5c0e2eccc1f21c913f63857301,stellar_sdk/xdr/claim_atom_type.py,0,2,8,0,8
arviz-devs/arviz,a0589d90c2f2e8b761ba54bae83d554ab10316a5,doc/source/conf.py,0,3,10,17,27
BirkbeckCTP/janeway,2752ad287f1c26ef5d0bd0b54a0130b5075f258c,src/press/templatetags/press_url.py,0,1,1,5,6
gajim/gajim,4648f0bbbc3920bdac5dae36a826de8ae191463d,gajim/common/jingle_transport.py,0,12,19,21,40
helfertool/helfertool,eb47e6df3416883df8f07f137494e2f351f7f300,src/help/migrations/0002_auto_20161108_1826.py,0,1,4,15,19
GoogleCloudPlatform/declarative-resource-client-library,a383a34f1a6f53cd72bdd4fe067aca1cadda9030,python/services/recaptchaenterprise/key.py,0,1,2,4,6
StellarCN/py-stellar-base,6850e0fec38a7c5c0e2eccc1f21c913f63857301,stellar_sdk/xdr/account_merge_result_code.py,0,2,8,0,8
mozilla/bedrock,f238e6a7d9e0fcfda3420aad16458d88af8138a2,bedrock/legal_docs/views.py,0,1,1,15,16
UrLab/DocHub,e5fbf3a9c77207f7e580cf7718b9b8f52166b34a,users/authBackend.py,0,2,11,19,30
UrLab/DocHub,460ef47e8f76c1d1bae35ce45fbd05ac60dc347e,users/authBackend.py,0,6,20,25,45
wagtail/wagtail,d10f15e55806c6944827d801cd9c2d53f5da4186,wagtail/images/api/v2/views.py,0,1,5,12,17
StellarCN/py-stellar-base,6850e0fec38a7c5c0e2eccc1f21c913f63857301,stellar_sdk/xdr/transaction_result_code.py,0,2,8,0,8
MozillaSecurity/FuzzManager,bb12ebd389864bbba8c2c9e15ab808efae54e660,server/covmanager/tasks.py,0,6,10,19,29
openego/eDisGo,6f5d5dece1e884ce8a3f260dd68f9dfb4278618e,edisgo/network/timeseries.py,0,14,25,25,50
openego/eDisGo,c6667a9490e35f822dba7acf378c6f0d35d1c2ab,edisgo/network/timeseries.py,0,1,191,0,191
openego/eDisGo,65287306157b4e2c2fb62e77dd87d5cec3ea0be9,edisgo/network/timeseries.py,0,6,16,20,36
frappe/erpnext,494bd9ef78313436f0424b918f200dab8fc7c20b,erpnext/buying/report/supplier_quotation_comparison/supplier_quotation_comparison.py,0,7,96,94,190
pekrau/Publications,e998977e05ddc6937de9ee6f8229c3661b219614,publications/uimodules.py,0,6,14,28,42
StellarCN/py-stellar-base,6850e0fec38a7c5c0e2eccc1f21c913f63857301,stellar_sdk/xdr/ledger_entry_change_type.py,0,2,8,0,8
wagtail/wagtail,d10f15e55806c6944827d801cd9c2d53f5da4186,wagtail/admin/api/views.py,0,4,36,43,79
jeremiah-c-leary/vhdl-style-guide,6820bbc266e7875bf76e015feb0533cebe95ebf0,vsg/rules/instantiation/rule_008.py,0,1,9,9,18
jeremiah-c-leary/vhdl-style-guide,ad87ea65ee434bed3e643cfc78ded2c0ec174dfe,vsg/rules/instantiation/rule_008.py,0,1,1,1,2
jeremiah-c-leary/vhdl-style-guide,ad87ea65ee434bed3e643cfc78ded2c0ec174dfe,vsg/rules/procedure/rule_501.py,0,1,1,1,2
pantsbuild/pants,29cf9fc8b25a540f32e4a9e0aeeaaa6ea4dcc48f,src/python/pants/build_graph/address.py,0,2,236,246,482
pantsbuild/pants,397e685577bf97c57a169bd02a0709edf67cf57e,src/python/pants/build_graph/address.py,0,4,31,29,60
pantsbuild/pants,21b4de538368d7b05072dca3eae36840d3809e00,src/python/pants/build_graph/address.py,1,7,23,83,106
fedspendingtransparency/data-act-broker-backend,de07da851d6395f323a2e393f62db43e7703b8f4,dataactcore/utils/fileD2.py,0,2,3,3,6
google/jax,00e040e5148ce8691937fba6def534429bd14b7f,jax/_src/scipy/stats/betabinom.py,0,2,3,3,6
wagtail/wagtail,d10f15e55806c6944827d801cd9c2d53f5da4186,wagtail/users/migrations/0006_userprofile_prefered_language.py,0,1,4,9,13
jeremiah-c-leary/vhdl-style-guide,ad87ea65ee434bed3e643cfc78ded2c0ec174dfe,vsg/rules/package/rule_016.py,0,1,1,1,2
jeremiah-c-leary/vhdl-style-guide,ad87ea65ee434bed3e643cfc78ded2c0ec174dfe,vsg/rules/attribute_declaration/rule_501.py,0,1,1,1,2
frappe/erpnext,bdcfab3a0fcd86c03250a6c5328191ca5cb2a226,erpnext/patches/v12_0/move_bank_account_swift_number_to_bank.py,0,1,11,5,16
frappe/erpnext,494bd9ef78313436f0424b918f200dab8fc7c20b,erpnext/patches/v12_0/move_bank_account_swift_number_to_bank.py,0,1,6,12,18
MozillaSecurity/FuzzManager,bb12ebd389864bbba8c2c9e15ab808efae54e660,server/crashmanager/Bugtracker/BugzillaREST.py,0,7,10,25,35
wagtail/wagtail,d10f15e55806c6944827d801cd9c2d53f5da4186,wagtail/documents/views/bulk_actions/add_tags.py,0,2,8,6,14
l33tdaima/l33tdaima,139e7285ea1ed4ee6f4f5f464e531fad0f2dca62,p583m/min_distance.py,0,1,2,6,8
jeremiah-c-leary/vhdl-style-guide,c962881e7ad9c909d2a1191e75fadd425fa61750,vsg/rules/component/rule_004.py,1,1,1,4,5
jeremiah-c-leary/vhdl-style-guide,ad87ea65ee434bed3e643cfc78ded2c0ec174dfe,vsg/rules/component/rule_004.py,0,1,1,1,2
StellarCN/py-stellar-base,6850e0fec38a7c5c0e2eccc1f21c913f63857301,stellar_sdk/xdr/allow_trust_result_code.py,0,2,8,0,8
dedupeio/dedupe,c28cd1363f9fcf3bb9c7769615e02bfc08ba45b1,dedupe/training.py,0,20,64,57,121
xupingmao/xnote,40afc18ec1718c165fca6584196ecc306261e99c,handlers/system/stats.py,0,2,2,6,8
jeremiah-c-leary/vhdl-style-guide,ad87ea65ee434bed3e643cfc78ded2c0ec174dfe,vsg/rules/context/rule_015.py,0,1,1,1,2
jeremiah-c-leary/vhdl-style-guide,ad87ea65ee434bed3e643cfc78ded2c0ec174dfe,vsg/rules/block/rule_503.py,0,1,1,1,2
pantsbuild/pants,3e9d83061cbc1b043c9e409c9b2485df09e8de1a,src/python/pants/backend/terraform/goals/check.py,0,2,3,2,5
jeremiah-c-leary/vhdl-style-guide,ad87ea65ee434bed3e643cfc78ded2c0ec174dfe,vsg/rules/context/rule_028.py,0,1,1,1,2
jeremiah-c-leary/vhdl-style-guide,ad87ea65ee434bed3e643cfc78ded2c0ec174dfe,vsg/rules/architecture/rule_019.py,0,1,1,1,2
GPflow/GPflow,bc686759ebd1a76f47c54d5253ee8418ee646c95,gpflow/models/training_mixins.py,0,4,9,11,20
apache/airflow,f011da235f705411239d992bc3c92f1c072f89a9,airflow/example_dags/example_branch_labels.py,0,1,2,5,7
valohai/valohai-cli,9a91dcd7c39db91621b69d7ab94262a178063557,valohai_cli/commands/pipeline/run/utils.py,0,2,19,7,26
jeremiah-c-leary/vhdl-style-guide,ad87ea65ee434bed3e643cfc78ded2c0ec174dfe,vsg/rules/signal/rule_008.py,0,1,1,1,2
sqall01/alertR,02450640d9a5cee8590d43349dfd48f15a5a5c41,sensorClientWeatherService/lib/sensor/tempForecast.py,0,3,20,28,48
frappe/erpnext,494bd9ef78313436f0424b918f200dab8fc7c20b,erpnext/selling/doctype/customer/customer_dashboard.py,0,1,40,22,62
jeremiah-c-leary/vhdl-style-guide,a820c8a30f36c3a6dfe40245047e2c789de75711,vsg/rules/type_definition/rule_010.py,0,1,1,1,2
frappe/erpnext,494bd9ef78313436f0424b918f200dab8fc7c20b,erpnext/buying/doctype/supplier/supplier_dashboard.py,0,1,25,12,37
frappe/erpnext,494bd9ef78313436f0424b918f200dab8fc7c20b,erpnext/manufacturing/doctype/routing/routing.py,0,2,5,10,15
DemocracyClub/UK-Polling-Stations,8544732dbf81b5ee58ad8e02c4de0c99e61e6c15,polling_stations/apps/data_importers/management/commands/import_colchester.py,0,1,29,28,57
DemocracyClub/UK-Polling-Stations,98192c8c672a988c25f959444e38cb26da1d414b,polling_stations/apps/data_importers/management/commands/import_colchester.py,0,1,79,4,83
StellarCN/py-stellar-base,6850e0fec38a7c5c0e2eccc1f21c913f63857301,stellar_sdk/xdr/manage_buy_offer_result_code.py,0,2,8,0,8
virtool/virtool,ea14f698e3fec5ca3e757295ca8307d1b28c62d2,virtool/uploads/api.py,0,0,0,0,0
virtool/virtool,280a3667c4c8ef7eefeb3e823e5e7a2eceb02df8,virtool/uploads/api.py,0,0,0,0,0
wagtail/wagtail,d10f15e55806c6944827d801cd9c2d53f5da4186,wagtail/project_template/home/migrations/0001_initial.py,0,1,5,15,20
genialis/resolwe-bio,03b4a49ec8f57947eac83a9a764cb4569e1352a4,resolwe_bio/processes/chip_seq/rose2.py,0,2,2,4,6
DIRACGrid/WebAppDIRAC,a53668878b347fac36630a3ef31481473d044912,src/WebAppDIRAC/WebApp/handler/SpaceOccupancyHandler.py,1,2,25,18,43
numba/llvmlite,7a403a317a454cae4da3e93ea8175266666ff11f,llvmlite/binding/ffi.py,0,1,30,10,40
tensorflow/tfx,17623dcada5c61165b4cca71deb4b57931fd8411,tfx/dsl/compiler/compiler.py,0,40,157,96,253
helfertool/helfertool,eb47e6df3416883df8f07f137494e2f351f7f300,src/registration/migrations/0045_auto_20210502_1717.py,0,1,4,6,10
PyCQA/pylint,585a574bc9936e3c0d2b1b20900e772ae3a8c6a5,pylint/checkers/spelling.py,0,1,1,3,4
streamlink/streamlink,e913fb036e83726c7ce5cf48f52ca2b2fef855f9,src/streamlink/utils/l10n.py,0,2,9,9,18
streamlink/streamlink,feb1534fa00ae53a19bf9816e786db4777f4542f,src/streamlink/utils/l10n.py,1,3,10,13,23
lmcinnes/pynndescent,1be184449f0266877886e1e99ad59d051f8e6ff4,pynndescent/rp_trees.py,0,2,2,10,12
KE-works/pykechain,86cfdcc5c1cfa768eb181843150e70081831e1f9,pykechain/models/sidebar/sidebar_button.py,0,7,52,39,91
frappe/erpnext,494bd9ef78313436f0424b918f200dab8fc7c20b,erpnext/selling/report/sales_person_commission_summary/sales_person_commission_summary.py,0,2,36,39,75
respawner/peering-manager,5fe14ec663c5b917c2ff8bdc16a73137c1b040de,utils/views.py,0,38,196,269,465
frappe/erpnext,494bd9ef78313436f0424b918f200dab8fc7c20b,erpnext/domains/manufacturing.py,0,1,18,21,39
UrLab/DocHub,78c2c966afc5cb735cf98963dff999f6a0469e87,catalog/models.py,1,2,0,5,5
UrLab/DocHub,aac1020db7932c1a523e3f3b2758085c171b9626,catalog/models.py,0,1,0,1,1
UrLab/DocHub,460ef47e8f76c1d1bae35ce45fbd05ac60dc347e,catalog/models.py,0,2,8,15,23
ECP-CANDLE/Benchmarks,70db7df26a01b0fa3e21651024f3cf697f8db494,common/darts/modules/network.py,0,0,0,0,0
ECP-CANDLE/Benchmarks,8cc5e04b8a54060de8a707f9a6dd25f1ddd10db5,common/darts/modules/network.py,0,10,33,40,73
ECP-CANDLE/Benchmarks,8cc5e04b8a54060de8a707f9a6dd25f1ddd10db5,examples/unet/unet_candle.py,0,3,20,29,49
rackerlabs/django-DefectDojo,ad2fa3bf4298a62df3a6d1e49971424005a4f906,dojo/tools/aws_prowler/parser.py,0,5,13,51,64
jeremiah-c-leary/vhdl-style-guide,a820c8a30f36c3a6dfe40245047e2c789de75711,vsg/rules/block/rule_200.py,0,1,1,1,2
jeremiah-c-leary/vhdl-style-guide,c962881e7ad9c909d2a1191e75fadd425fa61750,vsg/rules/entity/rule_010.py,1,1,1,4,5
jeremiah-c-leary/vhdl-style-guide,ad87ea65ee434bed3e643cfc78ded2c0ec174dfe,vsg/rules/entity/rule_010.py,0,1,1,1,2
spaam/svtplay-dl,3aef9a796eecfea77e9655cbc160988a39368f4e,lib/svtplay_dl/service/nrk.py,0,2,3,13,16
spaam/svtplay-dl,1f55acc3d4813fd03381c622e3424c0fbea53493,lib/svtplay_dl/service/nrk.py,0,2,23,15,38
frappe/erpnext,494bd9ef78313436f0424b918f200dab8fc7c20b,erpnext/patches/v13_0/update_dates_in_tax_withholding_category.py,0,1,10,11,21
UrLab/DocHub,bbabe9bb6e602e89b6f487c77fa739bde4989cd2,catalog/views.py,0,6,31,49,80
UrLab/DocHub,cc7c965a52811c20ef68e32d5a6b5722187ef4b8,catalog/views.py,0,7,53,46,99
qiniu/python-sdk,939ed7f599bbfed12104607931be2f79cd6dadf9,qiniu/region.py,2,5,10,45,55
automl/auto-sklearn,1a28632c8234b8bed4944d19109e029d2017fb73,autosklearn/data/feature_validator.py,0,2,9,7,16
pantsbuild/pants,bb19d2ea10a1232da2af2669c99fbb621e53a576,src/python/pants/backend/go/goals/tailor.py,0,3,106,3,109
pantsbuild/pants,897f5c8bb62133fce532771e8bc56cef2cc0626f,src/python/pants/backend/go/goals/tailor.py,0,1,4,3,7
pantsbuild/pants,fb82ff878f785c88cd28606b095995796a5717b4,src/python/pants/backend/go/goals/tailor.py,1,4,9,22,31
all-of-us/raw-data-repository,1602a980f2db03b69c34c8b002c78cf0de30af48,rdr_service/genomic/genomic_state_handler.py,0,2,2,3,5
jeremiah-c-leary/vhdl-style-guide,ad87ea65ee434bed3e643cfc78ded2c0ec174dfe,vsg/rules/generate/rule_600.py,0,1,1,1,2
kivy/python-for-android,e3f2d81a35a3047e4b1b1622a51a31735456ba36,pythonforandroid/archs.py,0,3,10,1,11
kivy/python-for-android,f7f8cea636714dc4843b8818c553510f99084b6a,pythonforandroid/archs.py,0,10,53,14,67
PyCQA/pylint,bd130ecd7ec5220c5371e2e056507ca8b1f02219,script/bump_changelog.py,3,1,145,100,245
StellarCN/py-stellar-base,6850e0fec38a7c5c0e2eccc1f21c913f63857301,stellar_sdk/xdr/scp_statement_type.py,0,2,8,0,8
StellarCN/py-stellar-base,6850e0fec38a7c5c0e2eccc1f21c913f63857301,stellar_sdk/xdr/operation_result_code.py,0,2,8,0,8
frappe/erpnext,e21e59614f79e5484fe78a6b82caf87eca015428,erpnext/patches/v10_0/item_barcode_childtable_migrate.py,1,0,0,0,0
frappe/erpnext,494bd9ef78313436f0424b918f200dab8fc7c20b,erpnext/patches/v10_0/item_barcode_childtable_migrate.py,0,1,15,19,34
jeremiah-c-leary/vhdl-style-guide,acb0c44b71ed3e4182757d2f593f29cf61630e6e,vsg/rules/process/rule_015.py,0,1,3,4,7
jeremiah-c-leary/vhdl-style-guide,ad87ea65ee434bed3e643cfc78ded2c0ec174dfe,vsg/rules/process/rule_015.py,0,1,1,1,2
diofant/diofant,ef0d3e7ecd05985750a20d6285f9fdce47b9616d,diofant/functions/special/delta_functions.py,0,1,2,3,5
abrt/retrace-server,f7490a06ba64016527190930c7a76d6ee0d0a64b,src/plugins/rhel.py,0,1,1,2,3
jeremiah-c-leary/vhdl-style-guide,c962881e7ad9c909d2a1191e75fadd425fa61750,vsg/rules/constant/rule_004.py,1,1,1,4,5
jeremiah-c-leary/vhdl-style-guide,ad87ea65ee434bed3e643cfc78ded2c0ec174dfe,vsg/rules/constant/rule_004.py,0,1,1,1,2
UrLab/DocHub,460ef47e8f76c1d1bae35ce45fbd05ac60dc347e,documents/admin.py,0,3,42,73,115
frappe/erpnext,494bd9ef78313436f0424b918f200dab8fc7c20b,erpnext/manufacturing/report/exponential_smoothing_forecasting/exponential_smoothing_forecasting.py,0,9,61,78,139
gitpython-developers/GitPython,21ec529987d10e0010badd37f8da3274167d436f,git/objects/tag.py,0,4,18,32,50
astropy/astropy,cefd6c9db6fa919e031a1d642daa282bc6d1c8d8,astropy/modeling/mappings.py,0,1,1,2,3
helfertool/helfertool,eb47e6df3416883df8f07f137494e2f351f7f300,src/registration/migrations/0049_auto_20210806_1249.py,0,1,7,18,25
GoogleCloudPlatform/python-docs-samples,f3554321f74ab6e54a4dbe4ef18f1edefcb65127,billing/main.py,2,1,50,45,95
google-research/kubric,cf7af7d37fc571e2de3da9cd4a774e33fc12ae48,examples/simulator.py,0,2,4,6,10
jeremiah-c-leary/vhdl-style-guide,ad87ea65ee434bed3e643cfc78ded2c0ec174dfe,vsg/rules/package/rule_017.py,0,1,1,1,2
StellarCN/py-stellar-base,6850e0fec38a7c5c0e2eccc1f21c913f63857301,stellar_sdk/xdr/bucket_entry_type.py,0,2,8,0,8
jeremiah-c-leary/vhdl-style-guide,ad87ea65ee434bed3e643cfc78ded2c0ec174dfe,vsg/rules/context/rule_013.py,0,1,1,1,2
google/glazier,9d3b44c05e82276ece613f8c7c51df239d533824,glazier/lib/config/base.py,0,2,3,4,7
StellarCN/py-stellar-base,6850e0fec38a7c5c0e2eccc1f21c913f63857301,stellar_sdk/xdr/payment_result_code.py,0,2,8,0,8
ECP-CANDLE/Benchmarks,89f27b1b05072484760b98d0d0de010ad4b16ed2,Pilot1/P1B1/p1b1.py,4,1,40,68,108
ECP-CANDLE/Benchmarks,8cc5e04b8a54060de8a707f9a6dd25f1ddd10db5,Pilot1/P1B1/p1b1.py,0,4,145,164,309
frappe/erpnext,494bd9ef78313436f0424b918f200dab8fc7c20b,erpnext/stock/report/incorrect_stock_value_report/incorrect_stock_value_report.py,0,6,35,31,66
jeremiah-c-leary/vhdl-style-guide,c203f3bc64b77dccedbc339a2c7805ea5db5cc9d,vsg/rules/component/rule_011.py,0,2,4,7,11
helfertool/helfertool,eb47e6df3416883df8f07f137494e2f351f7f300,src/badges/migrations/0007_badgesettings_language.py,0,1,4,9,13
jeremiah-c-leary/vhdl-style-guide,ad87ea65ee434bed3e643cfc78ded2c0ec174dfe,vsg/rules/type_definition/rule_004.py,0,1,1,1,2
MIT-LCP/wfdb-python,3b408f23f50889c7d1c6fee9329c76b739b9f667,wfdb/processing/qrs.py,0,52,139,238,377
jeremiah-c-leary/vhdl-style-guide,ad87ea65ee434bed3e643cfc78ded2c0ec174dfe,vsg/rules/signal/rule_010.py,0,1,1,1,2
mitmproxy/mitmproxy,b3587b52b25077f68116b9852b041d33e7fc6601,docs/scripts/api-events.py,0,12,13,16,29
googleapis/python-spanner,97faf6c11f985f128446bc7d9e99a22362bd1bc1,samples/samples/snippets.py,0,15,40,46,86
jumpserver/jumpserver,ab1024fbf4e73086ad0b246f8efce651a6d19e4b,apps/acls/urls/api_urls.py,0,1,1,0,1
Tuxemon/Tuxemon,2ee8582a84aa7515dcf94e10d712dec7ba3a4bdb,tuxemon/formula.py,0,2,5,14,19
catalyst-cooperative/pudl,431c5873674cf184dc4f4f464df59dbb4fa4d894,src/pudl/output/pudltabl.py,0,34,248,195,443
frappe/erpnext,494bd9ef78313436f0424b918f200dab8fc7c20b,erpnext/support/report/issue_analytics/issue_analytics.py,0,7,96,89,185
nstoik/farm_monitor,4ae0382f402da81310f569688cd19d640ff4915e,api/fm_api/app.py,0,1,1,1,2
virtool/virtool,3878db3bc4230113410d6fa056fe996be470b4ac,virtool/tasks/task.py,0,0,0,0,0
wagtail/wagtail,d10f15e55806c6944827d801cd9c2d53f5da4186,wagtail/documents/migrations/0001_initial.py,0,1,16,23,39
frappe/erpnext,494bd9ef78313436f0424b918f200dab8fc7c20b,erpnext/regional/report/irs_1099/irs_1099.py,0,7,36,40,76
helfertool/helfertool,eb47e6df3416883df8f07f137494e2f351f7f300,src/registration/migrations/0016_auto_20170209_1455.py,0,1,4,20,24
jeremiah-c-leary/vhdl-style-guide,ad87ea65ee434bed3e643cfc78ded2c0ec174dfe,vsg/rules/package/rule_010.py,0,1,1,1,2
wagtail/wagtail,d10f15e55806c6944827d801cd9c2d53f5da4186,wagtail/admin/migrations/0003_admin_managed.py,0,1,6,14,20
MozillaSecurity/FuzzManager,bb12ebd389864bbba8c2c9e15ab808efae54e660,server/taskmanager/migrations/0002_allow_unknown_task_status_and_run_time_calculation.py,0,1,12,16,28
MIT-LCP/wfdb-python,3b408f23f50889c7d1c6fee9329c76b739b9f667,wfdb/processing/evaluate.py,0,18,77,125,202
helfertool/helfertool,eb47e6df3416883df8f07f137494e2f351f7f300,src/badges/migrations/0003_badgedesign_bg_color.py,0,1,4,10,14
GoogleCloudPlatform/declarative-resource-client-library,a383a34f1a6f53cd72bdd4fe067aca1cadda9030,python/services/recaptchaenterprise/alpha/key.py,0,2,9,14,23
oppia/oppia,8f04c4b559eab93f28c155606106e9e86501cb5f,core/jobs/batch_jobs/user_stats_computation_jobs.py,0,4,2,11,13
scikit-learn/scikit-learn,33e4843e8839b87defcebe966063c5d04736854e,sklearn/utils/estimator_checks.py,0,3,23,3,26
StellarCN/py-stellar-base,6850e0fec38a7c5c0e2eccc1f21c913f63857301,stellar_sdk/xdr/path_payment_strict_receive_result_code.py,0,2,8,0,8
Tuxemon/Tuxemon,2ee8582a84aa7515dcf94e10d712dec7ba3a4bdb,tuxemon/menu/menu.py,0,9,23,36,59
jeremiah-c-leary/vhdl-style-guide,ad87ea65ee434bed3e643cfc78ded2c0ec174dfe,vsg/rules/block/rule_601.py,0,1,1,1,2
jeremiah-c-leary/vhdl-style-guide,b93b63ea0329d2636cc147f7486d77fd40d839d6,vsg/rules/architecture/rule_014.py,0,1,1,3,4
jeremiah-c-leary/vhdl-style-guide,5e1dae68ed970eb60cd25d295bc24c263094a064,vsg/rules/architecture/rule_014.py,0,1,20,3,23
jeremiah-c-leary/vhdl-style-guide,ad87ea65ee434bed3e643cfc78ded2c0ec174dfe,vsg/rules/architecture/rule_014.py,0,1,1,1,2
auth0/auth0-python,a9e746ab1596ca14fb5ccf923b66835138588d23,docs/source/conf.py,0,5,16,22,38
jeremiah-c-leary/vhdl-style-guide,ad87ea65ee434bed3e643cfc78ded2c0ec174dfe,vsg/rules/constant/rule_600.py,0,1,1,1,2
wagtail/wagtail,d10f15e55806c6944827d801cd9c2d53f5da4186,wagtail/images/migrations/0002_initial_data.py,0,1,22,24,46
frappe/erpnext,d3fb0fbb204393cd30de4c4e825d5167c3b9b271,erpnext/assets/doctype/asset_value_adjustment/asset_value_adjustment.py,0,2,4,7,11
frappe/erpnext,494bd9ef78313436f0424b918f200dab8fc7c20b,erpnext/assets/doctype/asset_value_adjustment/asset_value_adjustment.py,0,6,25,43,68
google/j2cl,7b78ec7ef116cf9f4c9190b87db4d3dc4d122f36,dev/replace_all.py,0,1,1,1,2
helfertool/helfertool,eb47e6df3416883df8f07f137494e2f351f7f300,src/registration/migrations/0043_auto_20200409_1711.py,0,1,7,18,25
wagtail/wagtail,d10f15e55806c6944827d801cd9c2d53f5da4186,wagtail/search/queryset.py,0,1,8,32,40
jeremiah-c-leary/vhdl-style-guide,ad87ea65ee434bed3e643cfc78ded2c0ec174dfe,vsg/rules/process/rule_019.py,0,1,1,1,2
wagtail/wagtail,d10f15e55806c6944827d801cd9c2d53f5da4186,wagtail/documents/views/multiple.py,0,6,33,40,73
ECP-CANDLE/Benchmarks,8cc5e04b8a54060de8a707f9a6dd25f1ddd10db5,Pilot3/P3B3/keras_mt_shared_cnn.py,0,2,32,49,81
astrobin/astrobin,d099eb1f682293f8a2570fef0c14fc1534f4a625,astrobin_apps_groups/utils.py,0,1,10,11,21
wagtail/wagtail,d10f15e55806c6944827d801cd9c2d53f5da4186,docs/conf.py,0,11,54,47,101
elastic/elasticsearch-py,016c87c2ea1a5e1485dfeebfa39be66540aac0dc,elasticsearch/_async/client/transform.py,0,10,10,10,20
apache/airflow,f011da235f705411239d992bc3c92f1c072f89a9,airflow/example_dags/example_task_group_decorator.py,0,2,2,5,7
PyAbel/PyAbel,015e3eb699113936b059a66754e2c38afafd70b0,doc/conf.py,0,2,54,53,107
mitmproxy/mitmproxy,b3587b52b25077f68116b9852b041d33e7fc6601,mitmproxy/contentviews/image/view.py,0,1,14,16,30
astropy/astropy,cefd6c9db6fa919e031a1d642daa282bc6d1c8d8,astropy/modeling/physical_models.py,0,3,4,7,11
blakeohare/crayon,ad97f6cccce8e848ca2a83751fe10d08dfe93e97,Scripts/syncU3.py,1,1,32,15,47
ccxt/ccxt,81ded008a8470117ea261fd47fabfc42d7c612dd,examples/py/async-with-threads.py,0,1,1,0,1
facelessuser/ColorHelper,2365d8b9b5e8f1054c575818bf4a1684d2f9d121,lib/coloraide/spaces/hsl/css.py,0,4,81,13,94
jeremiah-c-leary/vhdl-style-guide,ad87ea65ee434bed3e643cfc78ded2c0ec174dfe,vsg/rules/port/rule_007.py,0,1,1,1,2
mitmproxy/mitmproxy,b3587b52b25077f68116b9852b041d33e7fc6601,mitmproxy/hooks.py,0,3,2,7,9
frappe/erpnext,494bd9ef78313436f0424b918f200dab8fc7c20b,erpnext/stock/dashboard_chart_source/warehouse_wise_stock_value/warehouse_wise_stock_value.py,0,2,13,21,34
rocky/python3-trepan,165213ca5c39e822379abb92b5c4f0df8769535b,trepan/processor/parse/semantics.py,0,11,87,121,208
jeremiah-c-leary/vhdl-style-guide,ad87ea65ee434bed3e643cfc78ded2c0ec174dfe,vsg/rules/entity/rule_006.py,0,1,1,1,2
jeremiah-c-leary/vhdl-style-guide,ad87ea65ee434bed3e643cfc78ded2c0ec174dfe,vsg/rules/procedure/rule_009.py,0,1,1,1,2
wagtail/wagtail,d10f15e55806c6944827d801cd9c2d53f5da4186,wagtail/documents/migrations/0005_alter_uploaded_by_user_on_delete_action.py,0,1,4,11,15
ECP-CANDLE/Benchmarks,8cc5e04b8a54060de8a707f9a6dd25f1ddd10db5,Pilot3/P3B3/p3b3_baseline_keras2.py,0,9,52,64,116
dwavesystems/dimod,9b67e9fd99d9fdc2e947fe4c758fff5b51d1d9b3,dimod/reference/composites/fixedvariable.py,0,7,99,36,135
dwavesystems/dimod,b48ceb697fc4cf9a79aba39b50b274d289161df3,dimod/reference/composites/fixedvariable.py,0,1,67,4,71
radiasoft/pykern,9551826282bb90d1a4d73219af726637da75665c,pykern/pkplatform.py,0,5,5,11,16
frappe/erpnext,494bd9ef78313436f0424b918f200dab8fc7c20b,erpnext/accounts/doctype/accounting_dimension_filter/accounting_dimension_filter.py,0,2,14,32,46
frappe/erpnext,494bd9ef78313436f0424b918f200dab8fc7c20b,erpnext/patches/v11_0/add_expense_claim_default_account.py,0,1,1,6,7
StellarCN/py-stellar-base,6850e0fec38a7c5c0e2eccc1f21c913f63857301,stellar_sdk/xdr/message_type.py,0,2,8,0,8
fnp/wolnelektury,8952b9530d943655e552ea660c47e850123c5105,src/catalogue/views.py,0,7,12,22,34
fnp/wolnelektury,8a078a30db08afb680c48ce94d6e576236febeed,src/catalogue/views.py,0,2,1,7,8
wagtail/wagtail,d10f15e55806c6944827d801cd9c2d53f5da4186,scripts/nightly/upload.py,0,1,10,16,26
frappe/erpnext,494bd9ef78313436f0424b918f200dab8fc7c20b,erpnext/patches/v13_0/trim_whitespace_from_serial_nos.py,0,4,19,23,42
StellarCN/py-stellar-base,6850e0fec38a7c5c0e2eccc1f21c913f63857301,stellar_sdk/xdr/set_trust_line_flags_result_code.py,0,2,8,0,8
pantsbuild/pants,c70449c1be1b2979262e51d27c0bb1cef0183ccf,src/python/pants/backend/java/lint/google_java_format/rules.py,0,11,39,10,49
StellarCN/py-stellar-base,6850e0fec38a7c5c0e2eccc1f21c913f63857301,stellar_sdk/xdr/begin_sponsoring_future_reserves_result_code.py,0,2,8,0,8
jeremiah-c-leary/vhdl-style-guide,ad87ea65ee434bed3e643cfc78ded2c0ec174dfe,vsg/rules/package_body/rule_504.py,0,1,1,1,2
GoogleCloudPlatform/declarative-resource-client-library,a383a34f1a6f53cd72bdd4fe067aca1cadda9030,python/services/compute/forwarding_rule.py,0,5,10,20,30
spesmilo/electrum,fe2fbbd9b1b7598baf4b86c5696234944ca75a37,electrum/gui/qt/paytoedit.py,2,4,11,26,37
spesmilo/electrum,1f4cedf56a342ed4b1e1e5dea69e037dd1f8083f,electrum/gui/qt/paytoedit.py,8,9,66,114,180
ccxt/ccxt,81ded008a8470117ea261fd47fabfc42d7c612dd,examples/py/async-generator-basic.py,0,1,4,1,5
wagtail/wagtail,d10f15e55806c6944827d801cd9c2d53f5da4186,wagtail/images/migrations/0013_make_rendition_upload_callable.py,0,1,4,8,12
StellarCN/py-stellar-base,6850e0fec38a7c5c0e2eccc1f21c913f63857301,stellar_sdk/xdr/trust_line_flags.py,0,2,8,0,8
StellarCN/py-stellar-base,6850e0fec38a7c5c0e2eccc1f21c913f63857301,stellar_sdk/xdr/claim_claimable_balance_result_code.py,0,2,8,0,8
Splawik/pytigon,e7bcf7afca6feba49885d413a9d336fcb1f7dc4b,pytigon/prj/_schdata/schelements/models.py,0,4,32,0,32
ganga-devs/ganga,03576cc6f0f963d436e22e60dc4380fc24a92ab5,ganga/GangaCore/GPIDev/Lib/JobTree/JobTree.py,0,7,11,11,22
nerdvegas/rez,a27d583f689b70003b29cf0827716c27f847c258,src/rezplugins/shell/cmd.py,0,2,58,2,60
nerdvegas/rez,4ec8c6fd4d0c8ba8a673755006aff362ba4a5de4,src/rezplugins/shell/cmd.py,1,3,0,5,5
zulip/zulip,067196c508c1c81e0b362abcdcda46353c755a4d,tools/lib/provision_inner.py,0,2,5,7,12
zulip/zulip,feff1d0411875c70e6c9ee5729af10cd7f7cbef2,tools/lib/provision_inner.py,0,3,4,2,6
zulip/zulip,60f324518b0c674cdc33886186701e70df29f255,tools/lib/provision_inner.py,0,1,10,2,12
mapequation/infomap,73a8f68d4904cef5f96006a15e5896435dfcc0a7,examples/python/infomap-sklearn.py,0,1,3,12,15
FDio/vpp,d9b0c6fbf7aa5bd9af84264105b39c82028a4a29,src/plugins/nat/extras/nat_out2in_1Ms.py,0,1,10,14,24
mitmproxy/mitmproxy,38cca379df2af37fcd2417bfb8cb22defd4ca2cd,mitmproxy/tools/web/webaddons.py,0,1,2,2,4
mitmproxy/mitmproxy,b3587b52b25077f68116b9852b041d33e7fc6601,mitmproxy/tools/web/webaddons.py,0,2,22,20,42
jeremiah-c-leary/vhdl-style-guide,ad87ea65ee434bed3e643cfc78ded2c0ec174dfe,vsg/rules/context/rule_016.py,0,1,1,1,2
frappe/erpnext,494bd9ef78313436f0424b918f200dab8fc7c20b,erpnext/regional/doctype/import_supplier_invoice/import_supplier_invoice.py,0,9,113,142,255
MarlinFirmware/Marlin,8ccbac5317c5b07c3191a810bccb0e0aac1ef3e6,Marlin/src/lcd/extui/ftdi_eve_touch_ui/ftdi_eve_lib/scripts/svg2cpp.py,0,4,9,9,18
facebookexperimental/eden,2b1bda643c97ab9d8489c741d843019bd7d3b1f1,eden/integration/lib/edenclient.py,0,1,4,7,11
streamlink/streamlink,c854292d3dc9ef55c6b2adea55ba79189d530624,src/streamlink/plugins/telefe.py,0,1,39,32,71
frappe/erpnext,494bd9ef78313436f0424b918f200dab8fc7c20b,erpnext/accounts/report/trial_balance_for_party/trial_balance_for_party.py,0,7,73,84,157
googleapis/python-aiplatform,8779df5362a6851372cf3cea005a1c6c3096b19e,google/cloud/aiplatform/training_utils/cloud_profiler/plugins/tensorflow/tf_profiler.py,0,4,7,14,21
DFO-Ocean-Navigator/Ocean-Data-Map-Project,0ae5aaa57097b22a017d1271ae624e0f2c7f9245,data/class4.py,0,0,0,0,0
jeremiah-c-leary/vhdl-style-guide,ad87ea65ee434bed3e643cfc78ded2c0ec174dfe,vsg/rules/signal/rule_600.py,0,1,1,1,2
jab/bidict,6be66a1e0bb9b1980f60a0eb1651bc5a718f30da,bidict/_dup.py,2,3,7,7,14
fja05680/pinkfish,b875daec838d5101f01b57872a0d22c13ed1e6e3,examples/240.double-7s-portfolio/strategy.py,0,4,8,7,15
rocky/python-xdis,d8d0647bfff38a2c03815b72362ffc82ca9c3d87,xdis/magics.py,1,4,41,44,85
rocky/python-xdis,dd85aa89cc8b5c751cd32a70e04107016c849e3c,xdis/magics.py,0,14,159,187,346
rocky/python-xdis,566e935252a4f5b58c68d89cd7c63c9d87cb6793,xdis/magics.py,0,2,3,4,7
rocky/python-xdis,b8acb96f96ea4967831e118ce8203e6547f404aa,xdis/magics.py,0,2,6,11,17
rocky/python-xdis,f888df7df5cb8839927e9187c258769cc77fb7a3,xdis/magics.py,0,4,6,8,14
rocky/python-xdis,f9f965a2868b95dc658c4cd6ebf2e612ebb71987,xdis/magics.py,0,1,5,7,12
frappe/erpnext,494bd9ef78313436f0424b918f200dab8fc7c20b,erpnext/patches/v13_0/update_subscription_status_in_memberships.py,0,1,5,7,12
helfertool/helfertool,230b084a0fab8940e129f50c85ab78f474267e37,src/mail/models.py,0,2,3,3,6
UrLab/DocHub,80b42860e19e08561a47a4f6dbf0740d126a2a23,users/models.py,0,3,7,3,10
UrLab/DocHub,06d5ac757912e5087edf4f2fe5d1e1d2b050d7b6,users/models.py,0,4,18,1,19
UrLab/DocHub,fd5948097f630b3224f21b7ac2f50a9563359455,users/models.py,0,2,35,0,35
ikvk/imap_tools,26b1ae03b8476982639724d66c883766bb66ed74,examples/tls.py,0,1,2,2,4
jeremiah-c-leary/vhdl-style-guide,ad87ea65ee434bed3e643cfc78ded2c0ec174dfe,vsg/rules/procedure/rule_500.py,0,1,1,1,2
SimpleITK/SimpleITK,3b3eefd41c852c284c640b5e40f393e17967ceb8,Examples/ImageRegistrationMethod4/ImageRegistrationMethod4.py,0,5,20,19,39
codinuum/cca,d23168f8ed471436687fdea5d701788eb6caee8f,python/src/cca/ccautil/srcdiff.py,0,31,56,78,134
frappe/erpnext,494bd9ef78313436f0424b918f200dab8fc7c20b,erpnext/accounts/report/dimension_wise_accounts_balance_report/dimension_wise_accounts_balance_report.py,0,7,53,88,141
pantsbuild/pants,209b3542d48aad11a4bb88e8e9c62ed776013247,pants-plugins/internal_plugins/releases/register.py,0,1,2,2,4
pydoit/doit,0686b4ed8ad6b3014784e0a3c6d92d977fda3dc8,doit/cmd_base.py,1,6,5,32,37
pydoit/doit,87e923a7dfb7e9c2fcbec8297afd915e2641266c,doit/cmd_base.py,0,13,25,24,49
tensorflow/model-analysis,173dc366113d1f17e5ff3b79f8e50f13abc7cc7e,tensorflow_model_analysis/utils/model_util.py,0,13,108,64,172
jeremiah-c-leary/vhdl-style-guide,ad87ea65ee434bed3e643cfc78ded2c0ec174dfe,vsg/rules/port/rule_019.py,0,1,1,1,2
Azure/azure-sdk-for-python,ab4981cc4893bfb702f21c03466abec6bc6056ff,sdk/purview/azure-purview-catalog/azure/purview/catalog/_vendor.py,0,1,7,1,8
pypa/pip,6c3853a325b89fb356100bfe595ddd4a7214cdae,src/pip/_vendor/requests/adapters.py,0,20,92,138,230
DemocracyClub/UK-Polling-Stations,3bfb261406e4d87385443e61a2ff67aa65bad9b8,polling_stations/apps/data_importers/management/commands/import_worthing.py,0,1,17,7,24
matrix-org/synapse,1d5c80b16188c587427d663c3bec57e9c196dd1b,synapse/rest/client/receipts.py,0,1,12,8,20
jumpserver/jumpserver,10295569025b12b054e7692deda55105d1e07283,apps/settings/serializers/auth/feishu.py,0,1,1,3,4
virtool/virtool,8cd4ba503b66d294db0408d73dd746c5708dedf5,virtool/indexes/db.py,0,0,0,0,0
OGRECave/ogre,e7e4db594bbbc2a4c5b394e9467c842cfcb551c9,Samples/Python/raw_sample.py,0,1,1,1,2
the-blue-alliance/the-blue-alliance,e6ac301771fcb40ba82de46ebe3f36c920d15864,old_py2/api/apiv3_main.py,0,1,126,0,126
tensorflow/tflite-support,b58d0eb5bd652011c738c7cb60b0242efe24dec3,tensorflow_lite_support/python/task/vision/image_embedder.py,0,3,31,26,57
jeremiah-c-leary/vhdl-style-guide,ad87ea65ee434bed3e643cfc78ded2c0ec174dfe,vsg/rules/generate/rule_012.py,0,1,1,1,2
wagtail/wagtail,d10f15e55806c6944827d801cd9c2d53f5da4186,wagtail/documents/views/bulk_actions/document_bulk_action.py,0,2,8,13,21
fkie-cad/FACT_core,1dc27f9b3b3e5720badcefded26ac7768f8d7e4d,src/plugins/analysis/architecture_detection/code/architecture_detection.py,0,4,63,10,73
jeremiah-c-leary/vhdl-style-guide,3dd48d9464765d44a97e9c3fe9fd58bf76f1c57d,vsg/rules/for_loop/rule_005.py,0,1,22,6,28
Keeper-Security/Commander,a09f66cfc31bc9eb80c61f4c4a59d9c59dd06517,keepercommander/plugins/pspasswd/pspasswd.py,4,1,27,33,60
Catch-up-TV-and-More/plugin.video.catchuptvandmore,3b1ff469e98ef3313957d29525f41ecc5671ca4c,resources/lib/channels/ma/snrt.py,0,1,9,20,29
pantsbuild/pants,3de554d800899b935652fe062b409585ca9bd80c,src/python/pants/backend/python/goals/lockfile.py,0,4,56,81,137
abrt/retrace-server,c52459c3da20be9b6e2d9ed9067852d7d30c15d5,src/retrace/stats.py,0,3,3,6,9
GoogleCloudPlatform/declarative-resource-client-library,a383a34f1a6f53cd72bdd4fe067aca1cadda9030,python/services/recaptchaenterprise/beta/key.py,0,2,9,14,23
numba/numba,010e55c3fa7ecf993988a8ca0fb468e469fb329b,numba/core/base.py,0,9,27,13,40
oppia/oppia,46ee2fa3747afdba675cb26790aca1cbfc923468,core/domain/improvements_domain.py,0,6,24,8,32
opendatadurban/scoda,d5d66cdcfba03b1800bc365a1ef9071f50944352,rebuild_db.py,0,1,5,8,13
frappe/erpnext,494bd9ef78313436f0424b918f200dab8fc7c20b,erpnext/stock/dashboard/item_dashboard.py,0,1,29,46,75
google/atheris,714394b54dfc39e439dd83ef977b5dc85650ae06,src/instrument_bytecode.py,1,27,254,270,524
jeremiah-c-leary/vhdl-style-guide,ad87ea65ee434bed3e643cfc78ded2c0ec174dfe,vsg/rules/instantiation/rule_600.py,0,1,1,1,2
jeremiah-c-leary/vhdl-style-guide,ad87ea65ee434bed3e643cfc78ded2c0ec174dfe,vsg/rules/variable/rule_012.py,0,1,1,1,2
StellarCN/py-stellar-base,6850e0fec38a7c5c0e2eccc1f21c913f63857301,stellar_sdk/xdr/revoke_sponsorship_type.py,0,2,8,0,8
Tuxemon/Tuxemon,2ee8582a84aa7515dcf94e10d712dec7ba3a4bdb,tuxemon/mod_manager/symlink_missing.py,0,2,8,12,20
jeremiah-c-leary/vhdl-style-guide,ad87ea65ee434bed3e643cfc78ded2c0ec174dfe,vsg/rules/generate/rule_009.py,0,1,1,1,2
frappe/erpnext,494bd9ef78313436f0424b918f200dab8fc7c20b,erpnext/crm/report/opportunity_summary_by_sales_stage/opportunity_summary_by_sales_stage.py,0,7,119,106,225
StellarCN/py-stellar-base,6850e0fec38a7c5c0e2eccc1f21c913f63857301,stellar_sdk/xdr/signer_key_type.py,0,2,8,0,8
jeremiah-c-leary/vhdl-style-guide,ad87ea65ee434bed3e643cfc78ded2c0ec174dfe,vsg/rules/package_body/rule_506.py,0,1,1,1,2
hasgeek/funnel,6997b117c9a09fdefa03c92117138c6a8c44751a,funnel/models/video_mixin.py,0,1,2,9,11
mitmproxy/mitmproxy,042261266f5b901b2b0745fd108c9a92525e9087,mitmproxy/utils/strutils.py,1,2,17,17,34
mitmproxy/mitmproxy,b3587b52b25077f68116b9852b041d33e7fc6601,mitmproxy/utils/strutils.py,0,11,32,34,66
DemocracyClub/UK-Polling-Stations,fc9c1a45a7d946ac3e68b2a2679c13c3ea62a22b,polling_stations/apps/data_importers/management/commands/import_maidstone.py,1,1,35,13,48
helfertool/helfertool,eb47e6df3416883df8f07f137494e2f351f7f300,src/help/migrations/0004_auto_20210423_1854.py,0,1,4,16,20
helfertool/helfertool,eb47e6df3416883df8f07f137494e2f351f7f300,src/badges/migrations/0004_auto_20160306_1424.py,0,1,4,10,14
jeremiah-c-leary/vhdl-style-guide,ad87ea65ee434bed3e643cfc78ded2c0ec174dfe,vsg/rules/ranges/rule_001.py,0,1,1,1,2
frappe/erpnext,494bd9ef78313436f0424b918f200dab8fc7c20b,erpnext/patches/v12_0/create_accounting_dimensions_in_missing_doctypes.py,0,3,9,18,27
helfertool/helfertool,eb47e6df3416883df8f07f137494e2f351f7f300,src/mail/migrations/0009_alter_sentmail_user.py,0,1,4,6,10
stakira/OpenUtau,c8da163a9515d7fa60e5b5bfb0420253f30cc0b6,Misc/sync_strings.py,0,3,4,14,18
jeremiah-c-leary/vhdl-style-guide,c203f3bc64b77dccedbc339a2c7805ea5db5cc9d,vsg/rules/generic/rule_014.py,0,3,4,6,10
castlecms/castle.cms,2c5a7417ceb7b87162c0146563b3dc39378ba883,castle/cms/browser/controlpanel/crawler.py,0,3,34,19,53
jeremiah-c-leary/vhdl-style-guide,ad87ea65ee434bed3e643cfc78ded2c0ec174dfe,vsg/rules/subtype/rule_004.py,0,1,1,1,2
jeremiah-c-leary/vhdl-style-guide,ad87ea65ee434bed3e643cfc78ded2c0ec174dfe,vsg/rules/file_statement/rule_002.py,0,1,1,1,2
StellarCN/py-stellar-base,6850e0fec38a7c5c0e2eccc1f21c913f63857301,stellar_sdk/xdr/change_trust_result_code.py,0,2,8,0,8
pcolmant/repanier,5dc8882764d50b8f7d3650d848cb746a54297942,repanier/views/download_customer_invoice.py,0,0,0,0,0
pcolmant/repanier,578a066df4232933b285a6290e068faeb56fd4b9,repanier/views/download_customer_invoice.py,0,2,3,2,5
FCP-INDI/C-PAC,08b59fa135d97df2b3ef688d9f131cabfb3de2b4,CPAC/pipeline/nipype_pipeline_engine/engine.py,3,9,102,115,217
kiwitcms/Kiwi,6035da992ecdb06c59c93b745122eff19928d0f9,tcms/settings/common.py,0,12,101,93,194
kiwitcms/Kiwi,9c1f34444fc79369b09236fe2f2f81dfa14fe3d3,tcms/settings/common.py,0,1,4,0,4
jeremiah-c-leary/vhdl-style-guide,ad87ea65ee434bed3e643cfc78ded2c0ec174dfe,vsg/rules/ranges/rule_002.py,0,1,1,1,2
apache/airflow,c8af0592c08017ee48f69f608ad4a6529ee14292,airflow/typing_compat.py,0,0,0,0,0
wagtail/wagtail,d10f15e55806c6944827d801cd9c2d53f5da4186,wagtail/documents/admin.py,0,1,2,4,6
xupingmao/xnote,e452b9d17f052855a16c6b4f80b878919d4b8fff,handlers/note/note_stat.py,0,2,2,5,7
tensorflow/ranking,967ffd3edd8771b1e83960d23875013315137366,tensorflow_ranking/python/keras/losses.py,0,7,13,17,30
jeremiah-c-leary/vhdl-style-guide,c117fa55f6056fc1ac97f55c13c51308545a7ddc,vsg/rules/entity/rule_003.py,0,1,3,3,6
jeremiah-c-leary/vhdl-style-guide,a820c8a30f36c3a6dfe40245047e2c789de75711,vsg/rules/entity/rule_003.py,0,1,1,1,2
jeremiah-c-leary/vhdl-style-guide,ad87ea65ee434bed3e643cfc78ded2c0ec174dfe,vsg/rules/architecture/rule_021.py,0,1,1,1,2
deepmind/dm-haiku,ef8591ba92e6b5c6808ec84b9ce6db5309f03c78,haiku/_src/pad.py,0,2,1,2,3
frappe/bench,bb911b5e5a4a06d32c98e5f7951a9afe31f96081,bench/app.py,0,3,37,6,43
frappe/bench,a84239d6ab2e1b3c7fe459cf0896ca624375ed53,bench/app.py,0,19,35,42,77
frappe/bench,9988b8356bacf9df0d0d865baafab8a6cb8bb160,bench/app.py,2,15,30,93,123
frappe/bench,efb51712d92cc98331e76caad1755a22782c994b,bench/app.py,3,5,19,63,82
jeremiah-c-leary/vhdl-style-guide,ad87ea65ee434bed3e643cfc78ded2c0ec174dfe,vsg/rules/package_body/rule_201.py,0,1,1,1,2
frappe/erpnext,494bd9ef78313436f0424b918f200dab8fc7c20b,erpnext/buying/report/subcontracted_item_to_be_received/subcontracted_item_to_be_received.py,0,3,44,36,80
facelessuser/ColorHelper,2365d8b9b5e8f1054c575818bf4a1684d2f9d121,lib/coloraide/spaces/lch/css.py,0,4,80,13,93
miku/siskin,db3484669e040812bf2d4658c761898b41fb6e09,siskin/assets/65/65_analyse.py,0,3,8,19,27
DemocracyClub/UK-Polling-Stations,d9bb698d9ca504eac5811a0e619ecf91095e22b4,polling_stations/apps/data_importers/management/commands/import_winchester.py,0,1,21,11,32
Tuxemon/Tuxemon,2ee8582a84aa7515dcf94e10d712dec7ba3a4bdb,tuxemon/map_loader.py,0,8,17,78,95
nextstrain/augur,be89e10aa211703bf96367e0b1585a53069f879d,docs/conf.py,2,2,1,32,33
nextstrain/augur,74997c026d3a27c61d4b57594335eb237abb2728,docs/conf.py,0,1,1,1,2
nextstrain/augur,e32e712dea240b0f7d6028ca585c7fe2afe99327,docs/conf.py,0,1,1,8,9
wagtail/wagtail,d10f15e55806c6944827d801cd9c2d53f5da4186,wagtail/admin/views/pages/preview.py,0,5,20,26,46
radiasoft/sirepo,48eb6a685f43ac18e8bb6184cd689455e6040331,sirepo/sim_data/elegant.py,0,2,17,27,44
jeremiah-c-leary/vhdl-style-guide,c117fa55f6056fc1ac97f55c13c51308545a7ddc,vsg/rules/case/rule_007.py,0,1,3,3,6
jeremiah-c-leary/vhdl-style-guide,a820c8a30f36c3a6dfe40245047e2c789de75711,vsg/rules/case/rule_007.py,0,1,1,1,2
hasgeek/funnel,6997b117c9a09fdefa03c92117138c6a8c44751a,funnel/models/auth_client.py,1,23,26,58,84
jeremiah-c-leary/vhdl-style-guide,c962881e7ad9c909d2a1191e75fadd425fa61750,vsg/rules/entity/rule_008.py,1,1,1,4,5
jeremiah-c-leary/vhdl-style-guide,ad87ea65ee434bed3e643cfc78ded2c0ec174dfe,vsg/rules/entity/rule_008.py,0,1,1,1,2
wagtail/wagtail,d10f15e55806c6944827d801cd9c2d53f5da4186,wagtail/admin/forms/view_restrictions.py,0,1,11,21,32
jhpyle/docassemble,eec9ea18b3b7150a9f58a11cd6b92bce35bf322b,docassemble_webapp/docassemble/webapp/install_certs.py,0,4,4,5,9
mitmproxy/mitmproxy,fdde9ba3b3caaa2654048cec0af07bfcc3a6a3f8,mitmproxy/addons/view.py,0,18,22,23,45
mitmproxy/mitmproxy,f55ee1d44fb7e6bc4e597aa2a7b26bde017c4cad,mitmproxy/addons/view.py,0,1,1,0,1
rhinstaller/anaconda,ab7d1afa9435e9f01b66d79d7f83b57b55692f3b,pyanaconda/modules/storage/bootloader/base.py,1,3,21,23,44
rhinstaller/anaconda,c841c38095bfb984870bd0fd87185431c3ae7c5b,pyanaconda/modules/storage/bootloader/base.py,0,1,2,2,4
eljost/pysisyphus,03a9a9fe2919a2e3509af8880716702bd28f961b,pysisyphus/cos/GrowingString.py,1,17,57,111,168
matrix-org/synapse,e5716b631c6fe0b0a8510f16a5bffddb6396f434,synapse/push/bulk_push_rule_evaluator.py,0,8,341,53,394
FDio/vpp,d9b0c6fbf7aa5bd9af84264105b39c82028a4a29,src/plugins/nat/extras/nat_out2in_100ks.py,0,1,10,14,24
jeremiah-c-leary/vhdl-style-guide,ad87ea65ee434bed3e643cfc78ded2c0ec174dfe,vsg/rules/type_definition/rule_013.py,0,1,1,1,2
prometheus/client_python,4e0e7ff7e615601a35376c414b7081945ed417f8,prometheus_client/bridge/graphite.py,0,3,4,11,15
jeremiah-c-leary/vhdl-style-guide,c962881e7ad9c909d2a1191e75fadd425fa61750,vsg/rules/entity/rule_004.py,1,1,1,4,5
jeremiah-c-leary/vhdl-style-guide,ad87ea65ee434bed3e643cfc78ded2c0ec174dfe,vsg/rules/entity/rule_004.py,0,1,1,1,2
FDio/vpp,d9b0c6fbf7aa5bd9af84264105b39c82028a4a29,src/plugins/nat/extras/nat_100ks.py,0,1,10,14,24
mitmproxy/mitmproxy,b3587b52b25077f68116b9852b041d33e7fc6601,mitmproxy/contentviews/javascript.py,0,4,9,7,16
spulec/moto,6d68a5176bfb6efec6ba1c6b6f4db45973a35191,moto/ec2/responses/customer_gateways.py,0,1,2,1,3
wagtail/wagtail,d10f15e55806c6944827d801cd9c2d53f5da4186,wagtail/contrib/forms/migrations/0001_initial.py,0,1,8,18,26
Tuxemon/Tuxemon,2ee8582a84aa7515dcf94e10d712dec7ba3a4bdb,tuxemon/event/actions/common.py,0,2,3,12,15
fkie-cad/FACT_core,267d4b376b2cc077a58c9a7ba2237fbe17ecc5b4,src/plugins/analysis/users_and_passwords/install.py,0,3,7,3,10
astrobin/astrobin,05a345e83c7d4f5e02864d66a8aebf193a1bcbd0,astrobin_apps_forum/api/serializers/post_serializer.py,0,1,1,1,2
jeremiah-c-leary/vhdl-style-guide,ad87ea65ee434bed3e643cfc78ded2c0ec174dfe,vsg/rules/attribute_specification/rule_501.py,0,1,1,1,2
StellarCN/py-stellar-base,6850e0fec38a7c5c0e2eccc1f21c913f63857301,stellar_sdk/xdr/path_payment_strict_send_result_code.py,0,2,8,0,8
wagtail/wagtail,d10f15e55806c6944827d801cd9c2d53f5da4186,wagtail/admin/views/pages/convert_alias.py,0,1,12,21,33
PAHFIT/pypahfit,fe66940a99a2d90c097b8e4af542d6fe7ec75a16,pahfit/scripts/run_pahfit.py,0,2,7,15,22
StellarCN/py-stellar-base,6850e0fec38a7c5c0e2eccc1f21c913f63857301,stellar_sdk/xdr/threshold_indexes.py,0,2,8,0,8
matrix-org/synapse,116a4c8340b729ffde43be33df24d417384cb28b,synapse/handlers/receipts.py,0,6,38,27,65
jeremiah-c-leary/vhdl-style-guide,ad87ea65ee434bed3e643cfc78ded2c0ec174dfe,vsg/rules/block/rule_500.py,0,1,1,1,2
moodpulse/l2,ebf0291714e5886ab70733cdd5199d2ef52593f8,users/management/commands/export_research.py,0,1,2,10,12
specify/specify7,3646c56695697667b8c2579a6eec2e4b1813bb15,specifyweb/urls.py,0,1,1,1,2
specify/specify7,2f5801aca482878bfebb52d7fc8f912fe991770a,specifyweb/urls.py,0,2,14,2,16
jggatc/pyjsdl,b7f321f24cce89d7d2bc6484ef48ea7f81a3183b,pyjsdl/surfarray.py,0,0,0,0,0
jggatc/pyjsdl,cdabf205313c2998caa3393d552e16348c1ec591,pyjsdl/surfarray.py,0,9,25,40,65
radiasoft/sirepo,48eb6a685f43ac18e8bb6184cd689455e6040331,sirepo/sim_data/zgoubi.py,0,4,49,57,106
jeremiah-c-leary/vhdl-style-guide,ad87ea65ee434bed3e643cfc78ded2c0ec174dfe,vsg/rules/case/rule_015.py,0,1,1,1,2
frappe/erpnext,bfe18d6085d4b64e66e003ad7837c1c1341fdc08,erpnext/crm/doctype/appointment/appointment.py,1,0,0,0,0
frappe/erpnext,d1ee962d4b7e94518f1dc897660d064c6eac4169,erpnext/crm/doctype/appointment/appointment.py,1,0,0,0,0
frappe/erpnext,75db6f70735ab930d1dbab03d7b19317028b2653,erpnext/crm/doctype/appointment/appointment.py,16,0,0,0,0
frappe/erpnext,494bd9ef78313436f0424b918f200dab8fc7c20b,erpnext/crm/doctype/appointment/appointment.py,0,8,72,71,143
frappe/erpnext,8406720a7ad6c38b067f5cd685e3f61570ee03e6,erpnext/patches/v11_0/rename_bom_wo_fields.py,1,0,0,0,0
frappe/erpnext,494bd9ef78313436f0424b918f200dab8fc7c20b,erpnext/patches/v11_0/rename_bom_wo_fields.py,0,1,22,30,52
hasgeek/funnel,66932ccb641803edbd395f1fee9f79cfbfede996,funnel/views/helpers.py,0,2,40,0,40
hasgeek/funnel,58c2d73b4ea63a5ebd6e6916a9e6695a8431d0b2,funnel/views/helpers.py,7,1,316,52,368
hasgeek/funnel,9b26d7f04c41770d32b9a073873171772215dc60,funnel/views/helpers.py,1,5,11,82,93
hasgeek/funnel,dd9105efb3ba2d808c2510456e95143ca83b6e7a,funnel/views/helpers.py,1,5,5,26,31
StellarCN/py-stellar-base,6850e0fec38a7c5c0e2eccc1f21c913f63857301,stellar_sdk/xdr/clawback_result_code.py,0,2,8,0,8
Azure/azure-sdk-for-python,ea6200cdec48623f5d203638acce09fb6cdacdc2,sdk/eventhub/azure-eventhub/azure/eventhub/aio/_async_utils.py,0,2,4,6,10
GPflow/GPflow,aa9f042cb1b909908e1d3dc34e851ab6a5dff18e,gpflow/inducing_variables/multioutput/inducing_variables.py,0,2,18,26,44
DemocracyClub/UK-Polling-Stations,7664569cee84493a820a31eb8e1e69f83c2e75ac,polling_stations/apps/data_importers/management/commands/import_coventry.py,0,1,49,17,66
DemocracyClub/UK-Polling-Stations,bec0cd9f5f08a09391a93ce0d51bc3e79be220d5,polling_stations/apps/data_importers/management/commands/import_coventry.py,0,1,54,6,60
metabrainz/listenbrainz-server,069ec8fcc642b82a24943b1d0b8108b364096092,listenbrainz/db/model/feedback.py,0,3,7,4,11
jeremiah-c-leary/vhdl-style-guide,ad87ea65ee434bed3e643cfc78ded2c0ec174dfe,vsg/rules/port/rule_017.py,0,1,1,1,2
jeremiah-c-leary/vhdl-style-guide,6fcd0fa8377e0ffb29a94bccfec6f896ba019ef9,vsg/rules/architecture/rule_013.py,0,1,9,6,15
jeremiah-c-leary/vhdl-style-guide,ad87ea65ee434bed3e643cfc78ded2c0ec174dfe,vsg/rules/architecture/rule_013.py,0,1,1,1,2
googlecolab/colabtools,6edd31f9928f4d06fa778f8dca057af59a2fb823,google/colab/drive.py,0,0,0,0,0
googlecolab/colabtools,571db156067c26e6dee3081a950e815f556d47bf,google/colab/drive.py,0,8,50,15,65
cclib/cclib,504c482ed48c14e191f6fad5b72b00b4a61e061d,cclib/scripts/ccframe.py,0,1,1,3,4
osm-fr/osmose-frontend,b3f15d0bf840ad61175dbe5a858c88f821b7984f,osmose.py,0,1,164,26,190
osm-fr/osmose-frontend,758a5bf0d9beda2ba618b126a45a6656970efaf5,osmose.py,4,1,69,56,125
StellarCN/py-stellar-base,6850e0fec38a7c5c0e2eccc1f21c913f63857301,stellar_sdk/xdr/ledger_upgrade_type.py,0,2,8,0,8
nyu-devops/lab-flask-bdd,3c2d10a438cc35c3d4123afd1d3db8d3569f20f9,service/routes.py,0,9,19,21,40
PanDAWMS/panda-bigmon-core,d42b4e9cd1f908d4fdf7dca1244878dda6d19611,core/iDDS/views.py,0,1,3,4,7
MozillaSecurity/FuzzManager,bb12ebd389864bbba8c2c9e15ab808efae54e660,server/ec2spotmanager/serializers.py,0,3,28,56,84
mitmproxy/mitmproxy,b3587b52b25077f68116b9852b041d33e7fc6601,mitmproxy/addons/serverplayback.py,0,5,34,51,85
uclapi/uclapi,8010e0f0a9ca67c2566cb471b3be82be13af982c,backend/uclapi/timetable/management/commands/update_gencache.py,0,5,25,19,44
uclapi/uclapi,1d4c86ed33e8081370fb28d97ca44323206b2104,backend/uclapi/timetable/management/commands/update_gencache.py,0,1,399,10,409
zulip/zulip,b7241f20d5208d044a4712dfd5173b6a49026b9a,zerver/lib/timezone.py,0,1,1,0,1
zulip/zulip,81892df1768340472fe444eb9c514ff02d604aa0,zerver/lib/timezone.py,0,1,5,2,7
FDio/vpp,d9b0c6fbf7aa5bd9af84264105b39c82028a4a29,src/plugins/nat/extras/nat_out2in_10ks.py,0,1,10,14,24
wagtail/wagtail,d10f15e55806c6944827d801cd9c2d53f5da4186,wagtail/images/formats.py,0,4,11,19,30
frappe/erpnext,494bd9ef78313436f0424b918f200dab8fc7c20b,erpnext/patches/v11_0/update_sales_partner_type.py,0,1,8,11,19
wagtail/wagtail,d10f15e55806c6944827d801cd9c2d53f5da4186,wagtail/users/views/bulk_actions/set_active_state.py,0,3,16,15,31
jeremiah-c-leary/vhdl-style-guide,ad87ea65ee434bed3e643cfc78ded2c0ec174dfe,vsg/rules/generate/rule_003.py,0,1,1,1,2
frappe/erpnext,494bd9ef78313436f0424b918f200dab8fc7c20b,erpnext/manufacturing/report/downtime_analysis/downtime_analysis.py,0,4,42,24,66
hail-is/hail,2df6762013ec5d41c27d606224d6c819d018b00d,batch/batch/publicly_available_images.py,0,1,1,1,2
jeremiah-c-leary/vhdl-style-guide,a820c8a30f36c3a6dfe40245047e2c789de75711,vsg/rules/package_body/rule_200.py,0,1,1,1,2
jeremiah-c-leary/vhdl-style-guide,ad87ea65ee434bed3e643cfc78ded2c0ec174dfe,vsg/rules/procedure_call/rule_501.py,0,1,1,1,2
googleapis/google-cloud-php,914e3fef3ca4f4f9f2585f5748ca66fa088056f2,Kms/owlbot.py,0,2,32,7,39
jeremiah-c-leary/vhdl-style-guide,6948479138e6f10cfc9309b5eb483b18f0fc0075,vsg/rules/context/rule_025.py,0,1,7,4,11
jeremiah-c-leary/vhdl-style-guide,ad87ea65ee434bed3e643cfc78ded2c0ec174dfe,vsg/rules/context/rule_025.py,0,1,1,1,2
jeremiah-c-leary/vhdl-style-guide,ad87ea65ee434bed3e643cfc78ded2c0ec174dfe,vsg/rules/signal/rule_002.py,0,1,1,1,2
apache/allura,661de20bd5806eb761f5adef7a572019f2593985,Allura/allura/lib/solr.py,0,4,4,4,8
wagtail/wagtail,d10f15e55806c6944827d801cd9c2d53f5da4186,wagtail/admin/views/reports/base.py,0,3,3,9,12
RDFLib/rdflib,bdf9b06f103f2a18027aae320235e4d6ed42adb3,rdflib/plugins/shared/jsonld/context.py,0,1,1,1,2
tensorflow/similarity,71e02c4124717775374c47501c0639c9da3a568d,tensorflow_similarity/losses/simsiam.py,0,0,0,0,0
wagtail/wagtail,d10f15e55806c6944827d801cd9c2d53f5da4186,wagtail/documents/migrations/0005_document_collection.py,0,1,5,11,16
wagtail/wagtail,d10f15e55806c6944827d801cd9c2d53f5da4186,wagtail/images/admin.py,0,1,2,4,6
elastic/elasticsearch-py,016c87c2ea1a5e1485dfeebfa39be66540aac0dc,elasticsearch/_sync/client/transform.py,0,10,10,10,20
frappe/erpnext,e6952cb7f993c37d4f71be4ba6779c94257656f6,erpnext/buying/report/requested_items_to_order_and_receive/requested_items_to_order_and_receive.py,0,3,44,59,103
NetworkManager/NetworkManager-ci,c00c93a4bec008b1541c27b591ec098b438df459,run/centos-ci/gitlab_junit.py,0,1,5,11,16
GPflow/GPflow,705380d5e010d0953be20b93bdd5c7f77ad0e1c3,gpflow/models/util.py,0,1,5,4,9
GPflow/GPflow,bc686759ebd1a76f47c54d5253ee8418ee646c95,gpflow/models/util.py,0,4,6,10,16
boriel/zxbasic,0b3d4978c4dea5897b0607c3a8ad8890a1189bec,src/api/global_.py,0,2,4,1,5
frappe/erpnext,2851dfad9974c9a49feee8f05a4adb6971c5cceb,erpnext/stock/doctype/item_variant_settings/item_variant_settings.py,0,1,2,5,7
frappe/erpnext,494bd9ef78313436f0424b918f200dab8fc7c20b,erpnext/stock/doctype/item_variant_settings/item_variant_settings.py,0,1,13,30,43
ansible/ansible,cbb6a7f4e831abd2d56375fb0aa22465e0cc7c0c,lib/ansible/utils/unsafe_proxy.py,0,3,25,6,31
ansible/ansible,f41636b9b84003301af2d281bcf155cbb7b22c2c,lib/ansible/utils/unsafe_proxy.py,0,1,19,0,19
frappe/erpnext,494bd9ef78313436f0424b918f200dab8fc7c20b,erpnext/patches/v12_0/remove_bank_remittance_custom_fields.py,0,1,3,8,11
pekrau/Publications,e998977e05ddc6937de9ee6f8229c3661b219614,publications/utils.py,0,18,55,101,156
pekrau/Publications,7c2f53ea1185da6c7e43d48e71f9f0d726011029,publications/utils.py,0,2,107,0,107
danforthcenter/plantcv,108b5244e9b2a68ccd3b8e3080d394c7379448f1,plantcv/plantcv/hyperspectral/_inverse_covariance.py,0,1,9,9,18
astrobin/astrobin,bc74dff8bc8629f5ca7a2cfbc1b5f167c5038f99,astrobin_apps_iotd/templatetags/astrobin_apps_iotd_tags.py,0,2,33,3,36
astrobin/astrobin,efe67215b4805c78ec28a73039b2b50cf5737e42,astrobin_apps_iotd/templatetags/astrobin_apps_iotd_tags.py,0,3,89,0,89
StellarCN/py-stellar-base,6850e0fec38a7c5c0e2eccc1f21c913f63857301,stellar_sdk/xdr/asset_type.py,0,2,8,0,8
ECP-CANDLE/Benchmarks,8cc5e04b8a54060de8a707f9a6dd25f1ddd10db5,Pilot1/Uno/unoUQ_data.py,0,4,9,22,31
jeremiah-c-leary/vhdl-style-guide,ad87ea65ee434bed3e643cfc78ded2c0ec174dfe,vsg/rules/subprogram_body/rule_203.py,0,1,1,1,2
StellarCN/py-stellar-base,6850e0fec38a7c5c0e2eccc1f21c913f63857301,stellar_sdk/xdr/bump_sequence_result_code.py,0,2,8,0,8
StartupsPoleEmploi/labonneboite,adbd83fbfece7a56d5431bb52d79ff3a2a81f184,labonneboite/web/user/views.py,0,3,2,6,8
StartupsPoleEmploi/labonneboite,9522c7f3450244e116c18a61dcb85a020149b289,labonneboite/web/user/views.py,0,9,13,28,41
jeremiah-c-leary/vhdl-style-guide,2970b0a182e4832c73b54633c99bbec63b560532,vsg/vhdlFile/classify/interface_signal_declaration.py,0,0,0,0,0
jeremiah-c-leary/vhdl-style-guide,7225df8b9db9eb5b210c8b41597ad1d64eed5c3b,vsg/vhdlFile/classify/interface_signal_declaration.py,0,1,1,1,2
tensorflow/tfx-addons,4f55314e607f9587d4c621ee3ed1de0558f9cd48,tfx_addons/xgboost_evaluator/xgboost_predict_extractor.py,0,2,5,2,7
PyPSA/PyPSA,fc76389224e5bfb7609b0286e7809b97a38ccc7d,doc/conf.py,0,1,1,1,2
jeremiah-c-leary/vhdl-style-guide,ad87ea65ee434bed3e643cfc78ded2c0ec174dfe,vsg/rules/entity_specification/rule_501.py,0,1,1,1,2
tensorflow/privacy,36b8ea34ef9915e3db4c5f3e345fe20f16ca24eb,tensorflow_privacy/privacy/logistic_regression/multinomial_logistic.py,0,2,4,10,14
Azure/azure-sdk-for-python,0ceb22f93fa916db653b0030efa962c4f9626b81,sdk/keyvault/azure-keyvault-secrets/azure/keyvault/secrets/_shared/client_base.py,5,2,66,63,129
Azure/azure-sdk-for-python,a869b53e7ef723246c6f3e9ea443e9e076f1665c,sdk/keyvault/azure-keyvault-secrets/azure/keyvault/secrets/_shared/client_base.py,0,2,1,4,5
aerospike/aerospike-admin,ebc430c2e94bd303ee2600f3ca26a2d9026a7acf,lib/view/sheet/render/base_rsheet.py,0,29,80,131,211
aerospike/aerospike-admin,b45d056c1fe123542c8f01684462561889da8060,lib/view/sheet/render/base_rsheet.py,0,1,1,5,6
radiasoft/sirepo,48eb6a685f43ac18e8bb6184cd689455e6040331,sirepo/pkcli/zgoubi.py,0,5,47,55,102
helfertool/helfertool,eb47e6df3416883df8f07f137494e2f351f7f300,src/registration/migrations/0041_add_new_admins.py,0,1,4,6,10
MozillaSecurity/FuzzManager,bb12ebd389864bbba8c2c9e15ab808efae54e660,server/ec2spotmanager/templatetags/recursetags.py,0,2,4,6,10
jeremiah-c-leary/vhdl-style-guide,ad87ea65ee434bed3e643cfc78ded2c0ec174dfe,vsg/rules/function/rule_014.py,0,1,1,1,2
jeremiah-c-leary/vhdl-style-guide,be51fdff4a70684b5528b1153b776b6734cdb030,vsg/rules/for_loop/rule_003.py,1,1,18,11,29
jeremiah-c-leary/vhdl-style-guide,3dd48d9464765d44a97e9c3fe9fd58bf76f1c57d,vsg/rules/for_loop/rule_003.py,0,1,26,5,31
facelessuser/ColorHelper,2365d8b9b5e8f1054c575818bf4a1684d2f9d121,lib/coloraide/spaces/hwb/css.py,0,4,78,12,90
jeremiah-c-leary/vhdl-style-guide,c203f3bc64b77dccedbc339a2c7805ea5db5cc9d,vsg/rules/package/rule_002.py,0,2,4,5,9
isard-vdi/isard,fe68d0121019cc19adae5b0f5723545741ea2e08,api/src/api/views/AdminUsersView.py,0,2,42,12,54
ECP-CANDLE/Benchmarks,8cc5e04b8a54060de8a707f9a6dd25f1ddd10db5,common/generic_utils.py,0,10,57,63,120
frappe/erpnext,494bd9ef78313436f0424b918f200dab8fc7c20b,erpnext/accounts/custom/address.py,0,1,9,11,20
tensorflow/federated,5abe77f02b459e7ce02b9485631a872b0e2d0bed,tensorflow_federated/python/core/backends/mapreduce/form_utils.py,0,25,41,33,74
UrLab/DocHub,460ef47e8f76c1d1bae35ce45fbd05ac60dc347e,documents/logic.py,0,6,16,37,53
softlayer/softlayer-python,ac15931cc89e2822ffd69e20cbef317d0e598dd4,SoftLayer/fixtures/SoftLayer_Account.py,0,2,30,58,88
softlayer/softlayer-python,b3a3c1fdeac6da7e6e2c52889e6be8e1c5886ba2,SoftLayer/fixtures/SoftLayer_Account.py,0,2,40,30,70
frappe/erpnext,494bd9ef78313436f0424b918f200dab8fc7c20b,erpnext/templates/pages/material_request_info.py,0,2,6,19,25
helfertool/helfertool,eb47e6df3416883df8f07f137494e2f351f7f300,src/registration/migrations/0015_auto_20161111_1324.py,0,1,4,9,13
Tuxemon/Tuxemon,c7c6c40b6f44e0c26201c5d85a1c650f36aec29f,run_tuxemon.py,0,1,10,42,52
StellarCN/py-stellar-base,6850e0fec38a7c5c0e2eccc1f21c913f63857301,stellar_sdk/xdr/manage_sell_offer_result_code.py,0,2,8,0,8
openego/eDisGo,d0472bd7bfd6d0d7f5d7418a5c7be1fc99b9e31c,edisgo/tools/plots.py,1,2,250,82,332
openego/eDisGo,6f5d5dece1e884ce8a3f260dd68f9dfb4278618e,edisgo/tools/plots.py,0,7,8,9,17
openego/eDisGo,10509ef5a2d3653804c3d77a4d68115d15b3b4cb,edisgo/tools/plots.py,0,8,10,10,20
wagtail/wagtail,d10f15e55806c6944827d801cd9c2d53f5da4186,wagtail/admin/views/pages/listing.py,0,2,53,55,108
wagtail/wagtail,d10f15e55806c6944827d801cd9c2d53f5da4186,wagtail/contrib/redirects/migrations/0003_make_site_field_editable.py,0,1,4,8,12
veltzer/demos-linux,367af5fa887e70764c1d40efef1cfe26abc83872,config/deps.py,0,3,290,262,552
ray-project/ray,29d94a22114b02adfd3745c4991a3ce70592dd16,doc/source/custom_directives.py,3,3,98,19,117
frappe/erpnext,494bd9ef78313436f0424b918f200dab8fc7c20b,erpnext/patches/v11_0/add_index_on_nestedset_doctypes.py,0,1,1,11,12
jeremiah-c-leary/vhdl-style-guide,ad87ea65ee434bed3e643cfc78ded2c0ec174dfe,vsg/rules/package_body/rule_507.py,0,1,1,1,2
DigitalCampus/django-oppia,7f393f66bf89e50532fdfbc14d1bb844847d2c00,profile/views/manage.py,0,11,11,28,39
huggingface/transformers,b48ac1a094e572d6076b46a9e4ed3e0ebe978afc,examples/research_projects/codeparrot/scripts/initialize_model.py,0,1,1,5,6
pauliacomi/pyGAPS,aeb4b754377605ecbd4f5e9b9ae52386af4a9c8a,src/pygaps/parsing/aif.py,2,1,1,186,187
FDio/vpp,d9b0c6fbf7aa5bd9af84264105b39c82028a4a29,src/plugins/nat/extras/nat_10Ms.py,0,1,10,14,24
UrLab/DocHub,460ef47e8f76c1d1bae35ce45fbd05ac60dc347e,catalog/slug.py,0,5,5,8,13
jumpserver/jumpserver,7e2f81a418c3141b387e27be827076d2a48a503e,apps/tickets/utils.py,0,2,8,9,17
ROCmSoftwarePlatform/rocFFT,1b6eca8423b1e6f8e81207a46067227d74e44558,scripts/perf/perflib/build.py,0,2,2,2,4
astropy/astropy,1863c6eeb8ebe04ced89b9d1f2e3c0a511a6bf25,astropy/utils/iers/iers.py,0,2,30,28,58
astropy/astropy,d7c2f6cfb3e48856c81e076bca61638fe7b46250,astropy/utils/iers/iers.py,0,1,1,1,2
geopython/pycsw,8c64ef06228faa96594b052c73838e9584292708,pycsw/wsgi_flask.py,0,3,14,24,38
Cog-Creators/Red-DiscordBot,febca8ccbb10d4a618a20c5a25df86ca3532acb0,redbot/core/commands/context.py,0,4,13,3,16
jeremiah-c-leary/vhdl-style-guide,ad87ea65ee434bed3e643cfc78ded2c0ec174dfe,vsg/rules/architecture/rule_020.py,0,1,1,1,2
dprog-philippe-docourt/django-qr-code,273c344953469e0cb0e8c9ebf9f664dbd7a22fde,docs/conf.py,0,13,48,49,97
genialis/resolwe-bio,e05069ac9f7b12f6f1534af278e4b196ad4775ea,resolwe_bio/processes/import_data/metadata.py,6,2,100,172,272
wagtail/wagtail,d10f15e55806c6944827d801cd9c2d53f5da4186,wagtail/admin/views/pages/search.py,0,4,59,78,137
rupran/librarytrader,57c247aa209c1535a876dc3caa3d7eedfa4cceed,librarytrader/interface_calls.py,0,7,49,53,102
rupran/librarytrader,f91a96d7b6f541eecda1760b4fc8bacb682b6a76,librarytrader/interface_calls.py,0,2,18,43,61
rupran/librarytrader,cd3e8267d6836418d6fa3aa50dbc8d473e5f2afd,librarytrader/interface_calls.py,1,11,10,78,88
SimpleITK/SimpleITK,3b3eefd41c852c284c640b5e40f393e17967ceb8,Examples/ImageRegistrationMethod1/ImageRegistrationMethod1.py,0,5,17,18,35
frappe/erpnext,4e8fdf7b3fc2efea7d16398aa1dda11afdd2446d,erpnext/stock/doctype/quality_inspection/quality_inspection.py,3,1,33,61,94
frappe/erpnext,494bd9ef78313436f0424b918f200dab8fc7c20b,erpnext/stock/doctype/quality_inspection/quality_inspection.py,0,10,67,110,177
PyCQA/pylint,88512d0aefdab4598c228c121f02f7bbe86d8f48,pylint/extensions/broad_try_clause.py,0,1,3,5,8
StellarCN/py-stellar-base,6850e0fec38a7c5c0e2eccc1f21c913f63857301,stellar_sdk/xdr/set_options_result_code.py,0,2,8,0,8
mitmproxy/mitmproxy,b3587b52b25077f68116b9852b041d33e7fc6601,mitmproxy/contentviews/msgpack.py,0,2,5,4,9
mitmproxy/mitmproxy,41555edab98034fcc669ef90f25753533ab93327,mitmproxy/contentviews/msgpack.py,0,1,3,3,6
frappe/erpnext,494bd9ef78313436f0424b918f200dab8fc7c20b,erpnext/patches/v12_0/rename_pos_closing_doctype.py,0,1,8,10,18
jggatc/pyj2d,341e3868b745b50208100fa452dfaf499f9c2271,pyj2d/mask.py,0,0,0,0,0
jggatc/pyj2d,87cbecfb2c22eb4ef23e7e503cc8598cc36c7488,pyj2d/mask.py,0,5,6,13,19
StellarCN/py-stellar-base,6850e0fec38a7c5c0e2eccc1f21c913f63857301,stellar_sdk/xdr/liquidity_pool_withdraw_result_code.py,0,2,8,0,8
frappe/erpnext,aed79e993f51a7b2d4379359e516705115a55fd0,erpnext/stock/doctype/item_attribute/item_attribute.py,3,2,17,15,32
frappe/erpnext,6500ef404daca020b3eebdb16f31ef1e3c7c7153,erpnext/stock/doctype/item_attribute/item_attribute.py,0,2,4,11,15
frappe/erpnext,494bd9ef78313436f0424b918f200dab8fc7c20b,erpnext/stock/doctype/item_attribute/item_attribute.py,0,3,5,13,18
jeremiah-c-leary/vhdl-style-guide,a820c8a30f36c3a6dfe40245047e2c789de75711,vsg/rules/package/rule_003.py,0,1,1,1,2
jeremiah-c-leary/vhdl-style-guide,c117fa55f6056fc1ac97f55c13c51308545a7ddc,vsg/rules/context/rule_003.py,0,1,3,3,6
jeremiah-c-leary/vhdl-style-guide,a820c8a30f36c3a6dfe40245047e2c789de75711,vsg/rules/context/rule_003.py,0,1,1,1,2
oppia/oppia,54d3f462797695c8dd901595bd3a8fd00e345d94,core/domain/feedback_domain.py,0,5,17,7,24
marshmallow-code/marshmallow,ff633b21f5d223077a7a6a618ff146c059b61f9f,src/marshmallow/fields.py,0,3,2,12,14
marshmallow-code/marshmallow,6811434e7ffabe750388346d2c40d53f7bcab4e5,src/marshmallow/fields.py,1,50,239,185,424
IfcOpenShell/IfcOpenShell,43d0c098a0921c5de47d1c0903a3bfb482c6208f,src/ifcpatch/ifcpatch/recipes/OffsetObjectPlacements.py,2,3,49,32,81
wagtail/wagtail,d10f15e55806c6944827d801cd9c2d53f5da4186,wagtail/users/migrations/0008_userprofile_avatar.py,0,1,4,8,12
frappe/erpnext,494bd9ef78313436f0424b918f200dab8fc7c20b,erpnext/stock/doctype/item_alternative/item_alternative.py,0,3,20,38,58
frappe/erpnext,494bd9ef78313436f0424b918f200dab8fc7c20b,erpnext/patches/v11_0/rename_asset_adjustment_doctype.py,0,1,3,5,8
helfertool/helfertool,230b084a0fab8940e129f50c85ab78f474267e37,src/mail/views/list_mails.py,0,2,2,2,4
wagtail/wagtail,d10f15e55806c6944827d801cd9c2d53f5da4186,wagtail/documents/forms.py,0,5,17,25,42
f-droid/fdroidclient,80c0d4fd35d9917e3120a8cd8f6b30c756a0a5ed,tools/pick-complete-translations.py,0,3,13,51,64
Akuli/porcupine,405e533ff3841dc12c41a8ed64ea6ece301cb36f,scripts/build-exe-installer.py,0,4,10,15,25
Akuli/porcupine,5f9242b3874409a7724365aaf6c24001bedd1840,scripts/build-exe-installer.py,0,3,9,21,30
Akuli/porcupine,8088855ec777f5159114a096fcd47c09fbc8b1af,scripts/build-exe-installer.py,0,7,20,23,43
radiasoft/sirepo,917c3cd2f4926c91418e4ce88136e4e469b7d6f1,sirepo/template/zgoubi_parser.py,1,8,10,47,57
radiasoft/sirepo,48eb6a685f43ac18e8bb6184cd689455e6040331,sirepo/template/zgoubi_parser.py,0,9,331,405,736
adbar/htmldate,337f9c43bac52a2093d6cbd0bd8077feaf8a6038,htmldate/validators.py,0,1,1,3,4
adbar/htmldate,a9e1bf866ab9966c401b82cafb5943a0bd318779,htmldate/validators.py,0,9,37,62,99
jeremiah-c-leary/vhdl-style-guide,ad87ea65ee434bed3e643cfc78ded2c0ec174dfe,vsg/rules/component/rule_010.py,0,1,1,1,2
looker-open-source/sdk-codegen,b1650a1a8a56c52a7a06ca5c9cef02300af7289e,python/looker_sdk/rtl/serialize.py,0,4,73,30,103
CenterForOpenScience/osf.io,a30cf0fa03d5a7e03142cb26a3d96663e16e1546,osf/models/admin_profile.py,0,1,2,0,2
StellarCN/py-stellar-base,6850e0fec38a7c5c0e2eccc1f21c913f63857301,stellar_sdk/xdr/stellar_value_type.py,0,2,8,0,8
Catch-up-TV-and-More/plugin.video.catchuptvandmore,40a7dcbf69244c0d0116447dc67effaaa57b318f,resources/lib/channels/be/tvcom.py,0,3,4,10,14
FDio/vpp,d9b0c6fbf7aa5bd9af84264105b39c82028a4a29,src/plugins/nat/extras/nat_out2in_10Ms.py,0,1,10,14,24
GoogleCloudPlatform/python-docs-samples,88c4ee8b7355624e09009bbeff6b7d9834bd35f7,composer/workflows/dataproc_workflow_template_instantiate_operator_tutorial.py,0,1,2,4,6
GPflow/GPflow,6e43fecb3942b98dfc6da24237662da40deb54f1,gpflow/optimizers/scipy.py,2,4,21,54,75
GPflow/GPflow,aa9f042cb1b909908e1d3dc34e851ab6a5dff18e,gpflow/optimizers/scipy.py,0,2,30,28,58
gemrb/gemrb,46eb67e8afb4bd62102baabb5ddbbe3dc475691d,gemrb/GUIScripts/GUIRECCommon.py,0,1,1,1,2
gemrb/gemrb,b16eeef257df78510326470a70ee6a4e2ec62d0e,gemrb/GUIScripts/GUIRECCommon.py,0,6,7,7,14
jeremiah-c-leary/vhdl-style-guide,ad87ea65ee434bed3e643cfc78ded2c0ec174dfe,vsg/rules/process/rule_008.py,0,1,1,1,2
datajoint/datajoint-python,72ef4fdfbadadc00bfcd85e92dcb6380d0fd93ef,datajoint/admin.py,0,4,24,40,64
pantsbuild/pex,2b3bdee8cd99ffab0538a63fdd36de8de356f857,pex/finders.py,1,2,20,37,57
agdsn/pycroft,9ee4638aee503cb1db3a1cbe2cd1987ef0a45c62,pycroft/lib/swdd.py,0,1,6,3,9
miku/siskin,db3484669e040812bf2d4658c761898b41fb6e09,siskin/assets/65/65_table.py,0,2,3,6,9
jumpserver/jumpserver,10295569025b12b054e7692deda55105d1e07283,apps/settings/serializers/auth/dingtalk.py,0,1,1,3,4
DemocracyClub/UK-Polling-Stations,db7567265216a8714db298c10763f1e2dbe1d703,polling_stations/apps/data_importers/management/commands/import_newham.py,0,1,20,16,36
DemocracyClub/UK-Polling-Stations,a8edf0b1c8d522d45053c99e4ccbbb1e13bd7af6,polling_stations/apps/data_importers/management/commands/import_newham.py,0,1,30,3,33
helfertool/helfertool,eb47e6df3416883df8f07f137494e2f351f7f300,src/corona/migrations/0006_alter_coronasettings_rules.py,0,1,4,9,13
jeremiah-c-leary/vhdl-style-guide,ad87ea65ee434bed3e643cfc78ded2c0ec174dfe,vsg/rules/block/rule_501.py,0,1,1,1,2
wagtail/wagtail,d10f15e55806c6944827d801cd9c2d53f5da4186,wagtail/users/migrations/0005_make_related_name_wagtail_specific.py,0,1,4,8,12
jeremiah-c-leary/vhdl-style-guide,ad87ea65ee434bed3e643cfc78ded2c0ec174dfe,vsg/rules/package/rule_006.py,0,1,1,1,2
jeremiah-c-leary/vhdl-style-guide,ad87ea65ee434bed3e643cfc78ded2c0ec174dfe,vsg/rules/constant/rule_002.py,0,1,1,1,2
fkie-cad/FACT_core,9b3cf967d8d9de4b03ab5ed603e828bf8f204a28,src/flask_app_wrapper.py,1,2,33,12,45
fkie-cad/FACT_core,061ba71da42d30ceb6a2b514327a610767ac18a8,src/flask_app_wrapper.py,1,1,35,14,49
wagtail/wagtail,d10f15e55806c6944827d801cd9c2d53f5da4186,wagtail/contrib/redirects/wagtail_hooks.py,0,2,10,18,28
wagtail/wagtail,d10f15e55806c6944827d801cd9c2d53f5da4186,wagtail/search/migrations/0002_add_verbose_names.py,0,1,11,13,24
frappe/erpnext,494bd9ef78313436f0424b918f200dab8fc7c20b,erpnext/regional/report/vat_audit_report/vat_audit_report.py,0,11,67,63,130
jeremiah-c-leary/vhdl-style-guide,b93b63ea0329d2636cc147f7486d77fd40d839d6,vsg/rules/architecture/rule_012.py,0,1,1,3,4
jeremiah-c-leary/vhdl-style-guide,c203f3bc64b77dccedbc339a2c7805ea5db5cc9d,vsg/rules/architecture/rule_012.py,0,2,4,7,11
helfertool/helfertool,230b084a0fab8940e129f50c85ab78f474267e37,src/statistic/views/nutrition.py,0,3,4,3,7
FDio/vpp,d9b0c6fbf7aa5bd9af84264105b39c82028a4a29,src/plugins/nat/extras/nat_10ks.py,0,1,10,14,24
dials/dials,6218b9dbfaab16a6ccec1bf86831cd163ef31e58,doc/sphinx/update_release_list.py,3,2,45,74,119
helfertool/helfertool,eb47e6df3416883df8f07f137494e2f351f7f300,src/help/migrations/0003_auto_20170326_1736.py,0,1,4,16,20
ansible/ansible,1f59bbf4f39504c8f2087f8132f2475a6ac38dcb,lib/ansible/plugins/lookup/together.py,0,1,1,1,2
StellarCN/py-stellar-base,6850e0fec38a7c5c0e2eccc1f21c913f63857301,stellar_sdk/xdr/claimable_balance_id_type.py,0,2,8,0,8
frappe/erpnext,494bd9ef78313436f0424b918f200dab8fc7c20b,erpnext/patches/v14_0/rearrange_company_fields.py,0,1,19,58,77
espressif/esp-idf,583b98483743b8f6b24b5a6225a3822cefb3be7f,tools/esp_prov/prov/custom_prov.py,0,2,33,2,35
StellarCN/py-stellar-base,6850e0fec38a7c5c0e2eccc1f21c913f63857301,stellar_sdk/xdr/ip_addr_type.py,0,2,8,0,8
frappe/erpnext,494bd9ef78313436f0424b918f200dab8fc7c20b,erpnext/patches/v12_0/replace_accounting_with_accounts_in_home_settings.py,0,1,2,4,6
Splawik/pytigon,b5222b381ef97984b7383e222bc6e721260f3c5e,pytigon/schserw/schsys/templatetags/collapse.py,0,4,12,21,33
mitmproxy/mitmproxy,b3587b52b25077f68116b9852b041d33e7fc6601,mitmproxy/contentviews/css.py,0,2,2,4,6
openego/eDisGo,6f5d5dece1e884ce8a3f260dd68f9dfb4278618e,edisgo/tools/tools.py,0,2,4,3,7
openego/eDisGo,ce12b1cee1fad415326b850285d060d19f54d76f,edisgo/tools/tools.py,0,2,288,283,571
openego/eDisGo,10509ef5a2d3653804c3d77a4d68115d15b3b4cb,edisgo/tools/tools.py,0,2,3,3,6
openego/eDisGo,3119bbc4d4d029ba8e1a1250d85a34166bdee655,edisgo/tools/tools.py,0,1,1,2,3
openego/eDisGo,65287306157b4e2c2fb62e77dd87d5cec3ea0be9,edisgo/tools/tools.py,0,4,10,13,23
rocky/python3-trepan,165213ca5c39e822379abb92b5c4f0df8769535b,trepan/debugger.py,0,14,74,84,158
frappe/erpnext,494bd9ef78313436f0424b918f200dab8fc7c20b,erpnext/manufacturing/report/production_analytics/production_analytics.py,0,6,45,48,93
jeremiah-c-leary/vhdl-style-guide,c9e5dffefe3159db0449e7281adcf9f5963a8e62,vsg/rules/component/rule_012.py,1,1,35,8,43
jeremiah-c-leary/vhdl-style-guide,ad87ea65ee434bed3e643cfc78ded2c0ec174dfe,vsg/rules/component/rule_012.py,0,1,1,1,2
frappe/erpnext,494bd9ef78313436f0424b918f200dab8fc7c20b,erpnext/patches/v13_0/move_branch_code_to_bank_account.py,0,1,5,9,14
osm-fr/osmose-frontend,2b2b410d0475e34e562759b413f24b4f0ed06a13,modules/query_meta.py,0,6,46,77,123
googleapis/python-aiplatform,6720dd10ba06bd20f7806eb7ac35564c75433cdb,google/cloud/aiplatform_v1beta1/types/hyperparameter_tuning_job.py,0,1,2,2,4
jeremiah-c-leary/vhdl-style-guide,ad87ea65ee434bed3e643cfc78ded2c0ec174dfe,vsg/rules/context_ref/rule_004.py,0,1,1,1,2
jggatc/pyj2d,341e3868b745b50208100fa452dfaf499f9c2271,pyj2d/display.py,0,0,0,0,0
jggatc/pyj2d,87cbecfb2c22eb4ef23e7e503cc8598cc36c7488,pyj2d/display.py,0,3,3,10,13
GPflow/GPflow,a5587c121cccc4a762a16fd71fc7c2877d51ac47,gpflow/likelihoods/scalar_continuous.py,4,8,36,118,154
zulip/zulip,f21842e920d12276fd16895e28fa3a65a1af3fa4,zerver/views/video_calls.py,0,1,1,1,2
TheImagingSource/tiscamera,9596d1037bb38f9ef703d93c0464ccddf06bead0,examples/python/04-list-formats.py,0,9,24,19,43
jeremiah-c-leary/vhdl-style-guide,ad87ea65ee434bed3e643cfc78ded2c0ec174dfe,vsg/rules/entity_specification/rule_500.py,0,1,1,1,2
pantsbuild/pants,756a4489bba88690fda4b6c2366e19acde698e2f,src/python/pants/core/goals/repl.py,0,6,32,20,52
jeremiah-c-leary/vhdl-style-guide,ad87ea65ee434bed3e643cfc78ded2c0ec174dfe,vsg/rules/process/rule_017.py,0,1,1,1,2
StellarCN/py-stellar-base,6850e0fec38a7c5c0e2eccc1f21c913f63857301,stellar_sdk/xdr/liquidity_pool_type.py,0,2,8,0,8
jeremiah-c-leary/vhdl-style-guide,380d6856f9920391c3464067ddf3556c29d1cdbf,vsg/rules/instantiation/rule_028.py,1,1,18,7,25
jeremiah-c-leary/vhdl-style-guide,ad87ea65ee434bed3e643cfc78ded2c0ec174dfe,vsg/rules/instantiation/rule_028.py,0,1,1,1,2
gkunter/coquery,07b120ea131e9486608a0fd2093924a68f6bcba5,coquery/connections.py,24,0,0,0,0
gkunter/coquery,91072e3f826dc7528f6d71ac405363e238dd15e6,coquery/connections.py,0,13,42,36,78
Alexey-T/CudaText,9eed9bdea80797b5a1739ee11a48e213e8debf22,app/cudatext.app/Contents/Resources/py/sys/requests/adapters.py,0,21,89,140,229
frappe/erpnext,494bd9ef78313436f0424b918f200dab8fc7c20b,erpnext/patches/v12_0/set_task_status.py,0,1,4,6,10
wagtail/wagtail,d10f15e55806c6944827d801cd9c2d53f5da4186,wagtail/images/views/bulk_actions/image_bulk_action.py,0,1,7,10,17
MozillaSecurity/FuzzManager,bb12ebd389864bbba8c2c9e15ab808efae54e660,server/crashmanager/management/commands/triage_new_crashes.py,0,1,5,11,16
google/skia,8ae4efb2b58c5772dc7ff4c916e3e02ec1f71fc0,infra/bots/recipe_modules/gsutil/api.py,0,1,3,6,9
kovidgoyal/kitty,d6afe6f2cb0017e2d6b3ac7747df073857f5c242,__main__.py,0,1,180,1,181
osm-fr/osmose-frontend,2b2b410d0475e34e562759b413f24b4f0ed06a13,api/tool/tag2link.py,0,2,81,98,179
mapillary/OpenSfM,8a791d20b3bce6d2f5b810d8671125c1bbe5f435,opensfm/synthetic_data/synthetic_scene.py,0,2,27,26,53
mapillary/OpenSfM,7992d33965c4c20eee8e17a1ec5680efa37fdb13,opensfm/synthetic_data/synthetic_scene.py,0,5,9,11,20
ceph/teuthology,e6e287446a289bce19f8a4d9f97bd415d1084bbc,teuthology/orchestra/cluster.py,0,3,2,5,7
ceph/teuthology,2c8364818fe0bc1ae790a8d6d673262f730d1597,teuthology/orchestra/cluster.py,0,2,3,3,6
ceph/teuthology,c6442aa9e509aace1201390ea4c2d6a80e3d0800,teuthology/orchestra/cluster.py,1,4,7,49,56
pantsbuild/pants,c70449c1be1b2979262e51d27c0bb1cef0183ccf,src/python/pants/backend/python/lint/autoflake/rules.py,0,5,55,16,71
oppia/oppia,8f04c4b559eab93f28c155606106e9e86501cb5f,core/jobs/batch_jobs/exp_recommendation_computation_jobs.py,0,6,16,16,32
wagtail/wagtail,d10f15e55806c6944827d801cd9c2d53f5da4186,wagtail/contrib/search_promotions/migrations/0002_capitalizeverbose.py,0,1,9,11,20
jggatc/pyj2d,341e3868b745b50208100fa452dfaf499f9c2271,pyj2d/mouse.py,0,0,0,0,0
jggatc/pyj2d,87cbecfb2c22eb4ef23e7e503cc8598cc36c7488,pyj2d/mouse.py,0,3,3,6,9
johntellsall/shotglass,326c1cb22ca370e486d043477cac023dacb76654,shotglass/app/draw.py,0,4,5,10,15
jeremiah-c-leary/vhdl-style-guide,c117fa55f6056fc1ac97f55c13c51308545a7ddc,vsg/rules/component/rule_003.py,0,1,3,3,6
jeremiah-c-leary/vhdl-style-guide,a820c8a30f36c3a6dfe40245047e2c789de75711,vsg/rules/component/rule_003.py,0,1,1,1,2
joke2k/faker,60f0941a80519ff9106ec1b4dcffcbc7e23139e5,faker/factory.py,0,4,36,18,54
mittagessen/kraken,69d7db44f6cccec9812a0aadbc7c0a9805802ae8,kraken/contrib/heatmap_overlay.py,0,1,1,1,2
jeremiah-c-leary/vhdl-style-guide,ad87ea65ee434bed3e643cfc78ded2c0ec174dfe,vsg/rules/block/rule_600.py,0,1,1,1,2
jeremiah-c-leary/vhdl-style-guide,ad87ea65ee434bed3e643cfc78ded2c0ec174dfe,vsg/rules/block/rule_505.py,0,1,1,1,2
googleapis/python-storage,3664ddebe8746d0395acd86d5efa1ef973eeac3d,samples/snippets/storage_change_default_storage_class.py,0,1,1,1,2
wagtail/wagtail,d10f15e55806c6944827d801cd9c2d53f5da4186,wagtail/admin/views/pages/usage.py,0,2,9,15,24
facelessuser/ColorHelper,2365d8b9b5e8f1054c575818bf4a1684d2f9d121,lib/coloraide/spaces/oklch/css.py,0,4,80,13,93
radiasoft/sirepo,48eb6a685f43ac18e8bb6184cd689455e6040331,sirepo/sim_data/shadow.py,0,3,31,39,70
jeremiah-c-leary/vhdl-style-guide,c203f3bc64b77dccedbc339a2c7805ea5db5cc9d,vsg/rules/architecture/rule_031.py,0,2,4,7,11
frappe/erpnext,494bd9ef78313436f0424b918f200dab8fc7c20b,erpnext/patches/v13_0/create_uae_pos_invoice_fields.py,0,1,4,5,9
mozman/ezdxf,053992e9646eb76c0db550ad1d1e5ce61d88a452,examples/viewports_in_paperspace.py,0,4,9,12,21
OpenBfS/dokpool-plone,188b4e26ad92c63d524bd3cf3b01135a98e3873c,Plone/src/docpool.localbehavior/docpool/localbehavior/adapter.py,0,3,5,0,5
cobbler/cobbler,0b1a9e804fc9e2353096b485ac08656fbec3cc7b,cobbler/settings/migrations/V3_3_1.py,0,2,164,230,394
ECP-CANDLE/Benchmarks,8cc5e04b8a54060de8a707f9a6dd25f1ddd10db5,common/darts/modules/linear/network.py,0,10,27,35,62
frappe/erpnext,494bd9ef78313436f0424b918f200dab8fc7c20b,erpnext/patches/v11_0/rename_overproduction_percent_field.py,0,1,2,6,8
amccaugh/phidl,721460a7c4a6a7aa71c99f6fb5c28cc8e4a88f40,phidl/font.py,0,10,39,60,99
jeremiah-c-leary/vhdl-style-guide,bd5b882326e4f76a2facd6de6efb1c1f170abd5a,vsg/rules/generate/rule_005.py,1,1,18,11,29
jeremiah-c-leary/vhdl-style-guide,ad87ea65ee434bed3e643cfc78ded2c0ec174dfe,vsg/rules/generate/rule_005.py,0,1,1,1,2
openego/eDisGo,92324965763d62b38b892744782a2329490e4adc,edisgo/opf/results/opf_result_class.py,0,10,34,21,55
MozillaSecurity/FuzzManager,bb12ebd389864bbba8c2c9e15ab808efae54e660,server/covmanager/migrations/0002_increase_collection_filename_length.py,0,1,5,8,13
pydoit/doit,87e923a7dfb7e9c2fcbec8297afd915e2641266c,doit/task.py,0,11,19,19,38
MozillaSecurity/FuzzManager,bb12ebd389864bbba8c2c9e15ab808efae54e660,server/crashmanager/cron.py,0,3,6,8,14
Erotemic/ubelt,044dae377eb4818077f0bee6b03922c47d38483b,ubelt/util_stream.py,0,2,15,2,17
radiasoft/sirepo,48eb6a685f43ac18e8bb6184cd689455e6040331,sirepo/template/elegant_command_parser.py,0,4,44,50,94
jeremiah-c-leary/vhdl-style-guide,ad87ea65ee434bed3e643cfc78ded2c0ec174dfe,vsg/rules/if_statement/rule_025.py,0,1,1,1,2
conan-io/conan,beaca4195d700c944f0f7b098e267a509f78acb4,conan/tools/cmake/cmake.py,0,2,11,26,37
conan-io/conan,6852bab6ac65eb0ba6ca129b837d5bcc0b731147,conan/tools/cmake/cmake.py,0,1,2,4,6
conan-io/conan,3645fd34e4bef73c5ad869e1ca197af1686aada1,conan/tools/cmake/cmake.py,0,4,20,2,22
conan-io/conan,992be56077cad4562407a213529cef37d7bd9359,conan/tools/cmake/cmake.py,0,3,11,5,16
conan-io/conan,8f1f02f94bc811e0d0fbd2d7cabd0577eb63cd5a,conan/tools/cmake/cmake.py,0,3,13,5,18
conan-io/conan,1b8028aa63712c8bb58e5cb6b7dd029cf1ac08f9,conan/tools/cmake/cmake.py,0,3,12,4,16
conan-io/conan,cb472aa3c2539235df6c5dce1e74b262ec2b77d5,conan/tools/cmake/cmake.py,0,2,2,2,4
conan-io/conan,4f5ae35725d4be267766b2095fd4c797e8a863f2,conan/tools/cmake/cmake.py,0,1,1,6,7
conan-io/conan,98d1954cf7cad1c61d11522a1da51a456d6f8d78,conan/tools/cmake/cmake.py,1,5,59,20,79
conan-io/conan,95906539e3c92026c35824610d5976c175d10b30,conan/tools/cmake/cmake.py,1,6,60,21,81
conan-io/conan,5ae26263b43d999d9ad041f3b58f99a78f6035cc,conan/tools/cmake/cmake.py,0,1,1,2,3
conan-io/conan,e8918f4cee7d03cc574f848e835677312fe112fc,conan/tools/cmake/cmake.py,1,6,58,17,75
conan-io/conan,f9c0d67431b48d99b3d001c02bd93b570230da1d,conan/tools/cmake/cmake.py,1,7,59,21,80
conan-io/conan,c021ce7b959f3d4c23d9c789cbca9e14fd0168de,conan/tools/cmake/cmake.py,1,7,62,23,85
conan-io/conan,7b381791d3c207c0135c8030644f9f9e99e9ddc3,conan/tools/cmake/cmake.py,1,6,62,20,82
conan-io/conan,0fc655200bc095e547a80ae7146f8ca42268fc02,conan/tools/cmake/cmake.py,0,2,2,3,5
conan-io/conan,0966e79776537c02aea630f4380f2d82573abc06,conan/tools/cmake/cmake.py,1,7,94,26,120
jeremiah-c-leary/vhdl-style-guide,ad87ea65ee434bed3e643cfc78ded2c0ec174dfe,vsg/rules/if_statement/rule_030.py,0,1,1,1,2
cobbler/cobbler,d8677f0de9a846afb5088af58609e9b7bc31a99c,cobbler/modules/installation/post_report.py,0,1,6,6,12
MozillaSecurity/FuzzManager,bb12ebd389864bbba8c2c9e15ab808efae54e660,FTB/ProgramConfiguration.py,0,5,16,29,45
jeremiah-c-leary/vhdl-style-guide,ad87ea65ee434bed3e643cfc78ded2c0ec174dfe,vsg/rules/attribute_specification/rule_500.py,0,1,1,1,2
jeremiah-c-leary/vhdl-style-guide,ad87ea65ee434bed3e643cfc78ded2c0ec174dfe,vsg/rules/instantiation/rule_019.py,0,1,1,1,2
frappe/erpnext,57307443f04c7645889e9e8f41670f18f9ba63ee,erpnext/manufacturing/report/cost_of_poor_quality_report/cost_of_poor_quality_report.py,1,2,7,19,26
frappe/erpnext,494bd9ef78313436f0424b918f200dab8fc7c20b,erpnext/manufacturing/report/cost_of_poor_quality_report/cost_of_poor_quality_report.py,0,2,54,58,112
explosion/thinc,4b6ea956e9abef4e67043aed8ad7399bda0b0fbf,thinc/layers/concatenate.py,0,3,3,6,9
explosion/thinc,f6eee9a810190d14770eb1f31072e4e09c76a10a,thinc/layers/concatenate.py,0,6,20,25,45
SimpleITK/SimpleITK,3b3eefd41c852c284c640b5e40f393e17967ceb8,Examples/ImageRegistrationMethod3/ImageRegistrationMethod3.py,0,4,23,21,44
SimpleITK/SimpleITK,9e472d57e043a782ba33ee838373c96a736c9a1a,Examples/ImageRegistrationMethod3/ImageRegistrationMethod3.py,0,4,12,22,34
StellarCN/py-stellar-base,6850e0fec38a7c5c0e2eccc1f21c913f63857301,stellar_sdk/xdr/offer_entry_flags.py,0,2,8,0,8
wagtail/wagtail,d10f15e55806c6944827d801cd9c2d53f5da4186,wagtail/admin/widgets/filtered_select.py,0,3,16,36,52
matrix-org/synapse,7218a0ca1871c881070a25e33bb1198f51ba1e3a,synapse/handlers/identity.py,0,4,24,6,30
kovidgoyal/kitty,dc61adf9d85f9bf92c573abf8d02ff9a5299852e,logo/make.py,0,1,1,1,2
mitmproxy/mitmproxy,b3587b52b25077f68116b9852b041d33e7fc6601,mitmproxy/utils/emoji.py,0,1,3,8,11
jeremiah-c-leary/vhdl-style-guide,c203f3bc64b77dccedbc339a2c7805ea5db5cc9d,vsg/rules/port_map/rule_007.py,0,3,4,5,9
wagtail/wagtail,d10f15e55806c6944827d801cd9c2d53f5da4186,wagtail/documents/views/bulk_actions/delete.py,0,1,7,9,16
ROCmSoftwarePlatform/rocFFT,e13f3dc20e0af40a708a533c619930544a7a9601,scripts/perf/perflib/specs.py,0,2,24,34,58
ccxt/ccxt,2e5ccf3bfc90d401fbe31e71815b809f6e391478,examples/py/kraken-fetch-my-trades-pagination.py,1,1,7,2,9
ccxt/ccxt,f166333b3eb56a9ebe35034018a4e145dd476239,examples/py/kraken-fetch-my-trades-pagination.py,0,1,1,0,1
zmbc/shakespearelang,d3394e54bad6243cfc775af06f991abe38c31e38,shakespearelang/shakespeare.py,0,15,85,113,198
zmbc/shakespearelang,873a4471f017078787fba2615da8e3c35e2f8a0b,shakespearelang/shakespeare.py,3,8,408,49,457
Catch-up-TV-and-More/plugin.video.catchuptvandmore,c0539e2827278af4230591a460cac403ead2039d,resources/lib/skeletons/ca_live.py,0,9,18,33,51
kizniche/Mycodo,e10691c98e0621e20a14f0051f540f7e40013486,mycodo/devices/atlas_scientific_uart.py,0,1,1,1,2
ECP-CANDLE/Benchmarks,8cc5e04b8a54060de8a707f9a6dd25f1ddd10db5,Pilot1/UnoMT/utils/datasets/drug_target_dataset.py,0,4,45,54,99
jeremiah-c-leary/vhdl-style-guide,6948479138e6f10cfc9309b5eb483b18f0fc0075,vsg/rules/context/rule_023.py,0,1,7,4,11
jeremiah-c-leary/vhdl-style-guide,ad87ea65ee434bed3e643cfc78ded2c0ec174dfe,vsg/rules/context/rule_023.py,0,1,1,1,2
jeremiah-c-leary/vhdl-style-guide,c203f3bc64b77dccedbc339a2c7805ea5db5cc9d,vsg/rules/generic/rule_006.py,0,3,4,3,7
DemocracyClub/UK-Polling-Stations,3d2b457ddf843ebb1da735db0f94b650d598b60b,polling_stations/apps/data_importers/management/commands/import_bolton.py,0,2,33,9,42
DemocracyClub/UK-Polling-Stations,b7b141b2c4da57dd372cfe8f0b8b57e132e8bfa8,polling_stations/apps/data_importers/management/commands/import_bolton.py,0,2,69,11,80
pantsbuild/pants,99586affda282f43e6a295ac818b590c280d0e5c,src/python/pants/backend/terraform/lint/tffmt/tffmt.py,0,4,11,8,19
jeremiah-c-leary/vhdl-style-guide,ad87ea65ee434bed3e643cfc78ded2c0ec174dfe,vsg/rules/process/rule_022.py,0,1,1,1,2
OstapHEP/ostap,f308e47b53a69915c706b43f175c27d9ecccac2a,ostap/core/ostap_types.py,0,1,1,2,3
hazelcast/hazelcast-python-client,4d8219b3d2392d7f69695969b81b1851b60e9090,hazelcast/util.py,0,3,8,11,19
frappe/erpnext,494bd9ef78313436f0424b918f200dab8fc7c20b,erpnext/accounts/report/billed_items_to_be_received/billed_items_to_be_received.py,0,1,69,42,111
jeremiah-c-leary/vhdl-style-guide,ad87ea65ee434bed3e643cfc78ded2c0ec174dfe,vsg/rules/procedure/rule_505.py,0,1,1,1,2
jeremiah-c-leary/vhdl-style-guide,380d6856f9920391c3464067ddf3556c29d1cdbf,vsg/rules/instantiation/rule_027.py,1,1,18,8,26
jeremiah-c-leary/vhdl-style-guide,ad87ea65ee434bed3e643cfc78ded2c0ec174dfe,vsg/rules/instantiation/rule_027.py,0,1,1,1,2
Splawik/pytigon,b5222b381ef97984b7383e222bc6e721260f3c5e,pytigon/ext_lib/autocomplete.py,0,15,205,278,483
wagtail/wagtail,d10f15e55806c6944827d801cd9c2d53f5da4186,wagtail/contrib/forms/urls.py,0,1,6,14,20
SimpleITK/SimpleITK,3b3eefd41c852c284c640b5e40f393e17967ceb8,Examples/ImageRegistrationMethodExhaustive/ImageRegistrationMethodExhaustive.py,0,6,26,27,53
SimpleITK/SimpleITK,9e472d57e043a782ba33ee838373c96a736c9a1a,Examples/ImageRegistrationMethodExhaustive/ImageRegistrationMethodExhaustive.py,0,4,10,33,43
FDio/vpp,85465588b18fef9c4712f864f512e00741e2d4f2,src/vpp-api/python/vpp_papi/vpp_stats.py,0,3,3,7,10
FDio/vpp,d9b0c6fbf7aa5bd9af84264105b39c82028a4a29,src/vpp-api/python/vpp_papi/vpp_stats.py,0,14,135,173,308
ckan/ckanext-showcase,855604e79a274afb7e57eb70a833f2477866e288,ckanext/showcase/utils.py,0,1,104,0,104
DemocracyClub/UK-Polling-Stations,319939e61afdc5a533c9c4c80e5b4d3288be9d98,polling_stations/apps/data_importers/management/commands/import_rochford.py,0,1,23,16,39
frappe/erpnext,494bd9ef78313436f0424b918f200dab8fc7c20b,erpnext/manufacturing/report/bom_stock_report/bom_stock_report.py,0,5,13,22,35
frappe/erpnext,494bd9ef78313436f0424b918f200dab8fc7c20b,erpnext/assets/doctype/location/location.py,0,8,25,31,56
radiasoft/sirepo,48eb6a685f43ac18e8bb6184cd689455e6040331,sirepo/sim_data/warpvnd.py,0,5,60,63,123
jeremiah-c-leary/vhdl-style-guide,ad87ea65ee434bed3e643cfc78ded2c0ec174dfe,vsg/rules/variable/rule_002.py,0,1,1,1,2
wagtail/wagtail,d10f15e55806c6944827d801cd9c2d53f5da4186,wagtail/users/migrations/0007_userprofile_current_time_zone.py,0,1,4,9,13
Azure/azure-sdk-for-python,0ceb22f93fa916db653b0030efa962c4f9626b81,sdk/keyvault/azure-keyvault-keys/azure/keyvault/keys/_shared/client_base.py,5,2,66,63,129
Azure/azure-sdk-for-python,a869b53e7ef723246c6f3e9ea443e9e076f1665c,sdk/keyvault/azure-keyvault-keys/azure/keyvault/keys/_shared/client_base.py,0,2,1,4,5
frappe/erpnext,494bd9ef78313436f0424b918f200dab8fc7c20b,erpnext/patches/v11_0/merge_land_unit_with_location.py,0,1,33,37,70
radiasoft/pykern,9551826282bb90d1a4d73219af726637da75665c,pykern/pkio.py,0,11,15,19,34
apache/airflow,f6952db5f8688ab3c1944bde8f5178893a7f6089,airflow/models/tasklog.py,0,2,3,2,5
mitodl/bootcamp-ecommerce,833ade2fdeb5e13d05117048d2444e9cb3ad943f,main/urls.py,0,1,2,2,4
PyCQA/pylint,3c34ae7ce52b610068df82d26052c1b05586698e,pylint/checkers/misc.py,0,2,36,6,42
xia2/xia2,deacd11270ca26ddd335c4052c0150491695860b,src/xia2/Modules/MultiCrystal/ScaleAndMerge.py,0,3,188,2,190
frappe/erpnext,494bd9ef78313436f0424b918f200dab8fc7c20b,erpnext/accounts/doctype/payment_terms_template/payment_terms_template.py,0,2,4,7,11
jeremiah-c-leary/vhdl-style-guide,ad87ea65ee434bed3e643cfc78ded2c0ec174dfe,vsg/rules/length/rule_001.py,0,1,1,1,2
jeremiah-c-leary/vhdl-style-guide,ad87ea65ee434bed3e643cfc78ded2c0ec174dfe,vsg/rules/instantiation/rule_601.py,0,1,1,1,2
Splawik/pytigon,b5222b381ef97984b7383e222bc6e721260f3c5e,pytigon/schserw/schsys/templatetags/catch.py,0,3,17,19,36
wagtail/wagtail,d10f15e55806c6944827d801cd9c2d53f5da4186,wagtail/search/query.py,0,8,12,18,30
isard-vdi/isard,3389183789e4a7dca2e6ca9ef91a88ae3b09c7db,api/src/api/libv2/api_media.py,3,2,88,60,148
project-chip/connectedhomeip,e5bd5f3703b45b43b4cee4a5178586ca9fc01610,scripts/build/builders/ameba.py,0,1,2,9,11
wagtail/wagtail,d10f15e55806c6944827d801cd9c2d53f5da4186,wagtail/users/views/users.py,0,7,80,117,197
HTTPArchive/beta.httparchive.org,4e738fed3eca6a0bb9b37cac6f71543f4c8ed4c4,main.py,0,1,1,2,3
radiasoft/pykern,9551826282bb90d1a4d73219af726637da75665c,pykern/pkresource.py,0,4,12,19,31
googleapis/storage-testbench,502245535677b9d1271e21be797ccb7044444bc1,gcs/object.py,0,2,59,1,60
jeremiah-c-leary/vhdl-style-guide,ad87ea65ee434bed3e643cfc78ded2c0ec174dfe,vsg/rules/package_body/rule_505.py,0,1,1,1,2
jeremiah-c-leary/vhdl-style-guide,ad87ea65ee434bed3e643cfc78ded2c0ec174dfe,vsg/rules/length/rule_002.py,0,1,1,1,2
MarxMustermann/OfMiceAndMechs,e8b491aed5dacac50aac22884291eca7d5978514,src/itemFolder/industry/machine.py,0,12,98,167,265
MarxMustermann/OfMiceAndMechs,b0e6c279d7d5e4fb1bf66bc6d6c5e194fd4df5b0,src/itemFolder/industry/machine.py,0,1,2,1,3
helfertool/helfertool,eb47e6df3416883df8f07f137494e2f351f7f300,src/corona/migrations/0005_alter_coronasettings_rules.py,0,1,4,9,13
StellarCN/py-stellar-base,6850e0fec38a7c5c0e2eccc1f21c913f63857301,stellar_sdk/xdr/crypto_key_type.py,0,2,8,0,8
corradio/electricitymap,93100551d23423d3889b8884b80e7f42ecb01f4a,parsers/lib/zonekey.py,0,1,1,6,7
wagtail/wagtail,d10f15e55806c6944827d801cd9c2d53f5da4186,wagtail/users/templatetags/wagtailusers_tags.py,0,2,41,46,87
jeremiah-c-leary/vhdl-style-guide,620c13ad2051a1e13a5029203f1e33f31e1e4700,vsg/rules/component/rule_006.py,1,1,19,10,29
jeremiah-c-leary/vhdl-style-guide,ad87ea65ee434bed3e643cfc78ded2c0ec174dfe,vsg/rules/component/rule_006.py,0,1,1,1,2
jeremiah-c-leary/vhdl-style-guide,ad87ea65ee434bed3e643cfc78ded2c0ec174dfe,vsg/rules/library/rule_004.py,0,1,1,1,2
jeremiah-c-leary/vhdl-style-guide,c203f3bc64b77dccedbc339a2c7805ea5db5cc9d,vsg/rules/generic_map/rule_007.py,0,3,4,5,9
jeremiah-c-leary/vhdl-style-guide,ad87ea65ee434bed3e643cfc78ded2c0ec174dfe,vsg/rules/if_statement/rule_034.py,0,1,1,1,2
StellarCN/py-stellar-base,6850e0fec38a7c5c0e2eccc1f21c913f63857301,stellar_sdk/xdr/manage_offer_effect.py,0,2,8,0,8
helfertool/helfertool,eb47e6df3416883df8f07f137494e2f351f7f300,src/mail/tracking/handler.py,0,4,13,21,34
facelessuser/ColorHelper,931a5ff16af7adb35e8c6d3cae506dd9c380a58a,lib/coloraide/compositing/blend_modes.py,41,2,94,202,296
frappe/erpnext,494bd9ef78313436f0424b918f200dab8fc7c20b,erpnext/patches/v11_0/update_backflush_subcontract_rm_based_on_bom.py,0,1,5,9,14
jeremiah-c-leary/vhdl-style-guide,ad87ea65ee434bed3e643cfc78ded2c0ec174dfe,vsg/rules/package_body/rule_501.py,0,1,1,1,2
jeremiah-c-leary/vhdl-style-guide,ad87ea65ee434bed3e643cfc78ded2c0ec174dfe,vsg/rules/package/rule_013.py,0,1,1,1,2
SimpleITK/SimpleITK,3b3eefd41c852c284c640b5e40f393e17967ceb8,Examples/ImageRegistrationMethod2/ImageRegistrationMethod2.py,0,5,21,17,38
frappe/erpnext,494bd9ef78313436f0424b918f200dab8fc7c20b,erpnext/selling/report/territory_wise_sales/territory_wise_sales.py,0,6,20,54,74
fabioz/PyDev.Debugger,51f4ae23c75dfac83d8d22a6a197a94f126a92d2,_pydev_bundle/_pydev_calltip_util.py,0,3,8,5,13
frappe/erpnext,494bd9ef78313436f0424b918f200dab8fc7c20b,erpnext/selling/report/sales_partner_target_variance_based_on_item_group/item_group_wise_sales_target_variance.py,0,6,105,134,239
frappe/erpnext,494bd9ef78313436f0424b918f200dab8fc7c20b,erpnext/patches/v13_0/convert_qi_parameter_to_link_field.py,0,1,8,10,18
ECP-CANDLE/Benchmarks,8cc5e04b8a54060de8a707f9a6dd25f1ddd10db5,common/darts/api/info.py,0,3,10,15,25
frappe/erpnext,494bd9ef78313436f0424b918f200dab8fc7c20b,erpnext/accounts/doctype/bank_statement_import/bank_statement_import.py,0,10,18,29,47
StellarCN/py-stellar-base,6850e0fec38a7c5c0e2eccc1f21c913f63857301,stellar_sdk/xdr/liquidity_pool_deposit_result_code.py,0,2,8,0,8
jeremiah-c-leary/vhdl-style-guide,ad87ea65ee434bed3e643cfc78ded2c0ec174dfe,vsg/rules/attribute_declaration/rule_500.py,0,1,1,1,2
StellarCN/py-stellar-base,6850e0fec38a7c5c0e2eccc1f21c913f63857301,stellar_sdk/xdr/create_claimable_balance_result_code.py,0,2,8,0,8
ECP-CANDLE/Benchmarks,8cc5e04b8a54060de8a707f9a6dd25f1ddd10db5,Pilot1/UnoMT/unoMT_baseline_pytorch.py,0,3,21,24,45
hazelcast/hazelcast-python-client,4d8219b3d2392d7f69695969b81b1851b60e9090,hazelcast/predicate.py,0,26,36,38,74
andreymal/mini_fiction,af9b5b8d0f17fd0469bb5ede88c124287ac17c17,mini_fiction/views/index.py,0,3,3,3,6
jeremiah-c-leary/vhdl-style-guide,ad87ea65ee434bed3e643cfc78ded2c0ec174dfe,vsg/rules/package_body/rule_601.py,0,1,1,1,2
jeremiah-c-leary/vhdl-style-guide,ad87ea65ee434bed3e643cfc78ded2c0ec174dfe,vsg/rules/case/rule_016.py,0,1,1,1,2
tensorflow/docs,2c2ef3ffeb34b455ff8a2e00096cebae643f55f0,tools/tensorflow_docs/api_generator/doc_generator_visitor.py,17,9,39,73,112
ligo-cbc/pycbc,e8600c5be21cab8c6d052018086bc683f4f5499a,pycbc/workflow/minifollowups.py,0,1,53,19,72
ligo-cbc/pycbc,09eb6c67b25799cc63eb97de66fd24f7b2125e14,pycbc/workflow/minifollowups.py,0,4,12,38,50
ligo-cbc/pycbc,11142c548ee91c37c8819a2f5e81b65f78eac873,pycbc/workflow/minifollowups.py,0,11,85,43,128
CorralPeltzer/newTrackon,076a342ff4d3406daea8de54864d480c1835aa0c,newTrackon/trackon.py,1,2,11,20,31
radiasoft/sirepo,42e87fc1ee7754b9f69f705c18499d335b5e4ce2,sirepo/sim_api/jupyterhublogin.py,3,5,35,47,82
radiasoft/sirepo,48eb6a685f43ac18e8bb6184cd689455e6040331,sirepo/sim_api/jupyterhublogin.py,0,8,41,53,94
oppia/oppia,2bfdd9db6aeca80c752055a09ec06c10bc28cf18,core/domain/caching_services.py,0,1,1,1,2
jeremiah-c-leary/vhdl-style-guide,ad87ea65ee434bed3e643cfc78ded2c0ec174dfe,vsg/rules/package_body/rule_500.py,0,1,1,1,2
MozillaSecurity/FuzzManager,bb12ebd389864bbba8c2c9e15ab808efae54e660,FTB/ConfigurationFiles.py,0,4,5,10,15
StellarCN/py-stellar-base,6850e0fec38a7c5c0e2eccc1f21c913f63857301,stellar_sdk/xdr/envelope_type.py,0,2,8,0,8
idaholab/civet,ecb929bb207276e4f0c4a3f7a6cf2749491d8cb5,client/settings.py,0,2,11,0,11
awacha/cct,f180c5b8c2357f6d2d2991bbff51bfe5af11fd6c,cct/qtgui2/processingmain/closablemdisubwindow.py,0,2,5,6,11
facelessuser/ColorHelper,2365d8b9b5e8f1054c575818bf4a1684d2f9d121,lib/coloraide/spaces/oklab/css.py,0,4,80,13,93
jdfekete/progressivis,9f5056a097a7ec237f601fba4e8c160cbe2af527,progressivis/core/decorators.py,0,5,6,0,6
jeremiah-c-leary/vhdl-style-guide,ad87ea65ee434bed3e643cfc78ded2c0ec174dfe,vsg/rules/subprogram_body/rule_205.py,0,1,1,1,2
StellarCN/py-stellar-base,6850e0fec38a7c5c0e2eccc1f21c913f63857301,stellar_sdk/xdr/manage_data_result_code.py,0,2,8,0,8
dpressel/baseline,746fcf5fc8ec939094fb4f50939e15eddd7428df,mead/api_examples/ed_text.py,0,2,6,0,6
voussoir/etiquette,0e00a1e981ed4aabd3140c6a4536ed21a7dc5343,frontends/etiquette_flask/backend/endpoints/tag_endpoints.py,0,6,22,29,51
janeczku/calibre-web,9410b47144a4c78397701398e2c8f15ce2ebdc40,cps.py,0,2,63,10,73
jeremiah-c-leary/vhdl-style-guide,ad87ea65ee434bed3e643cfc78ded2c0ec174dfe,vsg/rules/variable/rule_600.py,0,1,1,1,2
jumpserver/jumpserver,e0fdfa52b94d889e8ab9c1184f901cb3d89df3d0,apps/settings/serializers/terminal.py,0,2,4,21,25
PyCQA/pylint,460a0c70d77a4fa600f653c9f4046595e8448888,pylint/checkers/imports.py,0,1,1,3,4
StellarCN/py-stellar-base,6850e0fec38a7c5c0e2eccc1f21c913f63857301,stellar_sdk/xdr/error_code.py,0,2,8,0,8
mitmproxy/mitmproxy,9d1e3107e851b3187c1270df189da74236e447f7,examples/addons/websocket-inject-message.py,0,1,1,1,2
nortikin/sverchok,00aa830f8c2980a676f1e823efdbcb5bcfaba362,core/socket_data.py,0,3,3,5,8
nortikin/sverchok,8979f0db7b60cf4f01ec2dfec40668ab1eea404a,core/socket_data.py,14,2,119,144,263
spectralDNS/shenfun,513ccc060635641d9cd5b40c5bb48a4b9a2c9387,shenfun/config.py,0,1,14,0,14
spectralDNS/shenfun,4ea844d641ec66207cf038945e453242ca288137,shenfun/config.py,0,2,4,8,12
jeremiah-c-leary/vhdl-style-guide,ad87ea65ee434bed3e643cfc78ded2c0ec174dfe,vsg/rules/package_body/rule_503.py,0,1,1,1,2
Fresnoy/kart,b660e3bc5aade797ab22f91de379a58b291fd443,diffusion/models.py,0,6,20,62,82
Fresnoy/kart,969cc7dd80ed8d08859a042ade769fa8853797fa,diffusion/models.py,0,1,3,5,8
zentralopensource/zentral,3c54013548717842d86b290f1fd2cfc8831f89f5,zentral/contrib/puppet/urls.py,0,1,6,26,32
frappe/erpnext,2fa2f7178d122fa3299b13ed0f2bb93e4fe7d6d5,erpnext/selling/doctype/sms_center/sms_center.py,0,0,0,0,0
frappe/erpnext,494bd9ef78313436f0424b918f200dab8fc7c20b,erpnext/selling/doctype/sms_center/sms_center.py,0,1,31,52,83
GPflow/GPflow,68d590a23ae7afb926acbc0cd067d437cdf709c2,gpflow/kernels/changepoints.py,0,1,7,1,8
jeremiah-c-leary/vhdl-style-guide,c203f3bc64b77dccedbc339a2c7805ea5db5cc9d,vsg/rules/case/rule_006.py,0,2,4,7,11
jeremiah-c-leary/vhdl-style-guide,a820c8a30f36c3a6dfe40245047e2c789de75711,vsg/rules/if_statement/rule_031.py,0,1,1,1,2
JamesJeffryes/MINE-Database,463ff161d570c6bdb7245bf7963125cc56db6778,minedatabase/metabolomics.py,0,5,9,13,22
JamesJeffryes/MINE-Database,2e311c1b3a2dfafb14b27254be8d3141dd2169ae,minedatabase/metabolomics.py,0,13,107,78,185
jeremiah-c-leary/vhdl-style-guide,ad87ea65ee434bed3e643cfc78ded2c0ec174dfe,vsg/rules/library/rule_005.py,0,1,1,1,2
adbar/htmldate,84ff4b596dca0940a8b633178866b75f394aa3ab,htmldate/utils.py,0,2,3,5,8
adbar/htmldate,a9e1bf866ab9966c401b82cafb5943a0bd318779,htmldate/utils.py,0,9,27,37,64
openego/eDisGo,e6fe1d82029bdc5f4f5e913a31df9a2a71818480,edisgo/tools/geo.py,0,3,45,56,101
openego/eDisGo,4ecfc9613b199b12773d339f396ca64c5c80b0b0,edisgo/tools/geo.py,0,9,41,30,71
wagtail/wagtail,d10f15e55806c6944827d801cd9c2d53f5da4186,wagtail/images/views/bulk_actions/delete.py,0,1,7,9,16
PyCQA/pylint,b4f5c4482e37045d75188bc3087196a70cdbe575,pylint/message/message_id_store.py,0,1,1,3,4
StellarCN/py-stellar-base,6850e0fec38a7c5c0e2eccc1f21c913f63857301,stellar_sdk/xdr/survey_message_command_type.py,0,2,8,0,8
kizniche/Mycodo,e10691c98e0621e20a14f0051f540f7e40013486,mycodo/functions/base_function.py,0,1,2,2,4
jeremiah-c-leary/vhdl-style-guide,ad87ea65ee434bed3e643cfc78ded2c0ec174dfe,vsg/rules/context/rule_014.py,0,1,1,1,2
explosion/spaCy,32954c3bcb36ce751799adedf4dc09a020bb0cfb,spacy/ml/models/entity_linker.py,0,1,1,1,2
ROCmSoftwarePlatform/rocFFT,e13f3dc20e0af40a708a533c619930544a7a9601,scripts/perf/perflib/utils.py,0,13,16,27,43
dedupeio/dedupe,f5213d79b10333aabe353da6e3ae1cca5802b17e,dedupe/backport.py,0,2,84,0,84
dedupeio/dedupe,442edec76a27f7d76f01c89de7327c35cbb898d7,dedupe/backport.py,0,1,1,8,9
wagtail/wagtail,d10f15e55806c6944827d801cd9c2d53f5da4186,wagtail/admin/migrations/0002_admin.py,0,1,6,14,20
DemocracyClub/UK-Polling-Stations,516d05c4e1abbf8dcdbd88024a39081b9c0e6eda,polling_stations/apps/data_importers/management/commands/import_torfaen.py,0,2,25,5,30
jeremiah-c-leary/vhdl-style-guide,c203f3bc64b77dccedbc339a2c7805ea5db5cc9d,vsg/rules/package_body/rule_100.py,0,3,4,5,9
cobbler/cobbler,0b1a9e804fc9e2353096b485ac08656fbec3cc7b,docs/conf.py,0,10,43,52,95
ECP-CANDLE/Benchmarks,8cc5e04b8a54060de8a707f9a6dd25f1ddd10db5,Pilot1/UnoMT/unoMT_pytorch_model.py,0,12,281,344,625
frappe/erpnext,494bd9ef78313436f0424b918f200dab8fc7c20b,erpnext/accounts/doctype/party_link/party_link.py,0,1,28,38,66
jepegit/cellpy,8278f3b43868d1669b122d18d2f4c40091982a27,cellpy/parameters/prms.py,0,1,0,3,3
jepegit/cellpy,20b9648c7ba6803e87cdc977a8a378315ea2de9e,cellpy/parameters/prms.py,0,1,2,3,5
jepegit/cellpy,9137c6a5d48d6a2fcc3b15b8aa37809ebd86de10,cellpy/parameters/prms.py,0,1,1,3,4
deepmind/dm_robotics,3ad8a732f51952a4cfb06e88729c7671f268d32c,py/moma/sensors/camera_sensor.py,0,3,2,18,20
wagtail/wagtail,5d81269548fc1a51f17c6e578586ac88f52250f1,wagtail/contrib/settings/views.py,1,5,6,19,25
wagtail/wagtail,d10f15e55806c6944827d801cd9c2d53f5da4186,wagtail/contrib/settings/views.py,0,5,23,31,54
jeremiah-c-leary/vhdl-style-guide,a820c8a30f36c3a6dfe40245047e2c789de75711,vsg/rules/generate/rule_004.py,0,1,1,1,2
mitmproxy/mitmproxy,b3587b52b25077f68116b9852b041d33e7fc6601,mitmproxy/contentviews/graphql.py,0,2,2,6,8
blueman-project/blueman,3b731840d8d41f3324564d559c2078398eda9c2f,blueman/plugins/applet/DisconnectItems.py,0,1,1,2,3
scalyr/scalyr-agent-2,cb92036b49367f8765914d2ce4d718bb76036818,scripts/circleci_usage_data.py,0,4,11,11,22
jeremiah-c-leary/vhdl-style-guide,ad87ea65ee434bed3e643cfc78ded2c0ec174dfe,vsg/rules/process/rule_036.py,0,1,1,1,2
jeremiah-c-leary/vhdl-style-guide,ad87ea65ee434bed3e643cfc78ded2c0ec174dfe,vsg/rules/case/rule_200.py,0,1,1,1,2
edx/edx-enterprise,4826aa2941ff67d95e3427ef13045db2c6e7e0c6,integrated_channels/cornerstone/urls.py,0,1,4,1,5
hail-is/hail,bfec377ca9faf3ed2caeb3982c3cda19b1ba6597,batch/batch/cloud/azure/driver/resource_manager.py,0,1,5,14,19
jeremiah-c-leary/vhdl-style-guide,ad87ea65ee434bed3e643cfc78ded2c0ec174dfe,vsg/rules/type_definition/rule_015.py,0,1,1,1,2
helfertool/helfertool,eb47e6df3416883df8f07f137494e2f351f7f300,src/registration/migrations/0002_event_date.py,0,1,4,8,12
the-blue-alliance/the-blue-alliance,c8ea847616bd757d4ccd073f45a41f64c93cb518,src/backend/common/queries/mobile_client_query.py,1,2,9,13,22
jeremiah-c-leary/vhdl-style-guide,c203f3bc64b77dccedbc339a2c7805ea5db5cc9d,vsg/rules/context/rule_017.py,0,2,4,7,11
PyCQA/pylint,b4f5c4482e37045d75188bc3087196a70cdbe575,pylint/utils/utils.py,0,1,1,3,4
PyCQA/pylint,c13d8d9a6ab234a39e03a6a4f76ff1c202bfbd4a,pylint/utils/utils.py,0,4,3,4,7
frappe/erpnext,494bd9ef78313436f0424b918f200dab8fc7c20b,erpnext/selling/report/item_wise_sales_history/item_wise_sales_history.py,0,5,106,77,183
mitmproxy/mitmproxy,794c18bec0d65aabd9793e2c3d2a5eac8753184a,mitmproxy/addons/intercept.py,0,1,3,0,3
kbd/setup,d09bdde7bcd0238c0fbeb663e251b7292f0d2ece,bootstrap.py,0,2,23,9,32
jeremiah-c-leary/vhdl-style-guide,c962881e7ad9c909d2a1191e75fadd425fa61750,vsg/rules/variable/rule_004.py,1,1,1,4,5
jeremiah-c-leary/vhdl-style-guide,ad87ea65ee434bed3e643cfc78ded2c0ec174dfe,vsg/rules/variable/rule_004.py,0,1,1,1,2
frappe/erpnext,494bd9ef78313436f0424b918f200dab8fc7c20b,erpnext/crm/doctype/appointment_booking_settings/appointment_booking_settings.py,0,2,9,10,19
nyu-devops/lab-flask-bdd,ca496f8315d9e8397651a52dc4718af4943ff306,features/steps/pets_steps.py,0,1,2,2,4
jeremiah-c-leary/vhdl-style-guide,ad87ea65ee434bed3e643cfc78ded2c0ec174dfe,vsg/rules/block/rule_502.py,0,1,1,1,2
GoogleCloudPlatform/python-docs-samples,9c2ea53ad5a6cd7bbfaf125daec0d21b28749130,cloud-sql/postgres/sqlalchemy/main.py,3,1,48,96,144
jeremiah-c-leary/vhdl-style-guide,c9e5dffefe3159db0449e7281adcf9f5963a8e62,vsg/rules/entity/rule_012.py,1,1,44,8,52
jeremiah-c-leary/vhdl-style-guide,ad87ea65ee434bed3e643cfc78ded2c0ec174dfe,vsg/rules/entity/rule_012.py,0,1,1,1,2
DemocracyClub/UK-Polling-Stations,2cbef7f10d2a705172453d957175a6108c788e1e,polling_stations/apps/data_importers/management/commands/import_plymouth.py,0,1,11,2,13
Catch-up-TV-and-More/plugin.video.catchuptvandmore,b2461e1a7606c01c215990b410403e1bf901a88b,resources/lib/channels/ma/medi1.py,0,1,9,10,19
wagtail/wagtail,d10f15e55806c6944827d801cd9c2d53f5da4186,wagtail/images/views/bulk_actions/add_tags.py,0,2,8,6,14
jeremiah-c-leary/vhdl-style-guide,ad87ea65ee434bed3e643cfc78ded2c0ec174dfe,vsg/rules/constant/rule_015.py,0,1,1,1,2
radiasoft/sirepo,48eb6a685f43ac18e8bb6184cd689455e6040331,sirepo/sim_data/silas.py,0,3,14,19,33
jeremiah-c-leary/vhdl-style-guide,ad87ea65ee434bed3e643cfc78ded2c0ec174dfe,vsg/rules/package_body/rule_203.py,0,1,1,1,2
wagtail/wagtail,d10f15e55806c6944827d801cd9c2d53f5da4186,wagtail/admin/filters.py,0,7,15,25,40
Tuxemon/Tuxemon,2ee8582a84aa7515dcf94e10d712dec7ba3a4bdb,tuxemon/ui/text.py,0,4,4,19,23
StellarCN/py-stellar-base,6850e0fec38a7c5c0e2eccc1f21c913f63857301,stellar_sdk/xdr/account_flags.py,0,2,8,0,8
DataDog/integrations-extras,c3b20ac25e0f52c1ebb85cce2217076dfdd0f3f1,stardog/datadog_checks/stardog/stardog.py,3,2,84,70,154
wagtail/wagtail,d10f15e55806c6944827d801cd9c2d53f5da4186,wagtail/utils/sendfile.py,0,6,16,24,40
ECP-CANDLE/Benchmarks,8cc5e04b8a54060de8a707f9a6dd25f1ddd10db5,common/darts/api/model.py,0,2,9,12,21
jeremiah-c-leary/vhdl-style-guide,ad87ea65ee434bed3e643cfc78ded2c0ec174dfe,vsg/rules/entity_specification/rule_503.py,0,1,1,1,2
radiasoft/pykern,9551826282bb90d1a4d73219af726637da75665c,pykern/pkjson.py,0,3,4,14,18
voussoir/etiquette,85055cdea257c2a711a7dbfbf7c857268901bd6d,frontends/etiquette_flask/etiquette_flask_dev.py,0,2,23,35,58
spulec/moto,f2d14a9dc2d0bd8e80c24306713af12a3948079b,moto/cloudfront/models.py,1,2,2,24,26
frappe/erpnext,494bd9ef78313436f0424b918f200dab8fc7c20b,erpnext/patches/v12_0/set_employee_preferred_emails.py,0,2,3,7,10
dwavesystems/dimod,b48ceb697fc4cf9a79aba39b50b274d289161df3,dimod/reference/composites/roofduality.py,0,1,71,5,76
wagtail/wagtail,d10f15e55806c6944827d801cd9c2d53f5da4186,wagtail/images/migrations/0011_image_collection.py,0,1,5,11,16
GPflow/GPflow,bc686759ebd1a76f47c54d5253ee8418ee646c95,gpflow/models/gpr.py,0,4,4,11,15
DigitalCampus/django-oppia,7f393f66bf89e50532fdfbc14d1bb844847d2c00,oppia/migrations/0041_auto_20210816_1057.py,0,1,5,6,11
jeremiah-c-leary/vhdl-style-guide,ad87ea65ee434bed3e643cfc78ded2c0ec174dfe,vsg/rules/case/rule_018.py,0,1,1,1,2
tensorflow/tfx,8935778823afcd007ed480ef1e089e6519404690,tfx/types/channel.py,20,7,8,155,163
wagtail/wagtail,d10f15e55806c6944827d801cd9c2d53f5da4186,wagtail/snippets/models.py,0,3,10,21,31
wellenvogel/avnav,b464dc9304ca4106c9392f3f85cb9ad9805a78c2,server/handler/layouthandler.py,1,1,144,5,149
mitmproxy/mitmproxy,b3587b52b25077f68116b9852b041d33e7fc6601,mitmproxy/addons/mapremote.py,0,2,3,7,10
StellarCN/py-stellar-base,6850e0fec38a7c5c0e2eccc1f21c913f63857301,stellar_sdk/xdr/memo_type.py,0,2,8,0,8
jeremiah-c-leary/vhdl-style-guide,a95bd0487335334a5da2850a543e404412d6ed0a,vsg/rules/entity/rule_007.py,0,2,4,5,9
jeremiah-c-leary/vhdl-style-guide,c203f3bc64b77dccedbc339a2c7805ea5db5cc9d,vsg/rules/entity/rule_007.py,0,2,4,7,11
jeremiah-c-leary/vhdl-style-guide,ad87ea65ee434bed3e643cfc78ded2c0ec174dfe,vsg/rules/process/rule_004.py,0,1,1,1,2
PyAbel/PyAbel,015e3eb699113936b059a66754e2c38afafd70b0,examples/example_basex_gaussian.py,0,1,14,16,30
jumpserver/jumpserver,de3865fa1dbc4031bd1de56892ba9151120a9efa,apps/users/filters.py,0,1,4,4,8
jumpserver/jumpserver,e259d2a9e9167c58fa75a78d1050dd5dcfde96f4,apps/users/filters.py,2,1,50,24,74
jeremiah-c-leary/vhdl-style-guide,ad87ea65ee434bed3e643cfc78ded2c0ec174dfe,vsg/rules/process/rule_009.py,0,1,1,1,2
jeremiah-c-leary/vhdl-style-guide,ad87ea65ee434bed3e643cfc78ded2c0ec174dfe,vsg/rules/if_statement/rule_026.py,0,1,1,1,2
candlepin/subscription-manager,835a6b80ee84237b0796ad464438e5b6e5ab0523,src/rhsmlib/services/syspurpose.py,0,4,6,7,13
wagtail/wagtail,d10f15e55806c6944827d801cd9c2d53f5da4186,wagtail/documents/api/v2/views.py,0,1,5,12,17
jeremiah-c-leary/vhdl-style-guide,ad87ea65ee434bed3e643cfc78ded2c0ec174dfe,vsg/rules/type_definition/rule_011.py,0,1,1,1,2
lutris/lutris,f2fa4e1daa978b0b3548c47982fb4811e0180d9e,lutris/gui/widgets/notifications.py,0,1,18,11,29
liangliangyy/DjangoBlog,f4d7f9e153585e25f15df8fec189544077f80180,comments/urls.py,0,1,1,0,1
facelessuser/ColorHelper,2365d8b9b5e8f1054c575818bf4a1684d2f9d121,lib/coloraide/spaces/lab/css.py,0,4,80,13,93
jggatc/pyj2d,341e3868b745b50208100fa452dfaf499f9c2271,pyj2d/key.py,0,0,0,0,0
jggatc/pyj2d,87cbecfb2c22eb4ef23e7e503cc8598cc36c7488,pyj2d/key.py,0,1,1,3,4
zulip/zulip,46acb608b1fd91602058b96f01a9f478aad2fbec,zerver/tornado/ioloop_logging.py,0,0,0,0,0
zulip/zulip,e4bf7066f3e1c78de7dfacbe727ba4c277e51cd9,zerver/tornado/ioloop_logging.py,0,1,79,1,80
frappe/erpnext,494bd9ef78313436f0424b918f200dab8fc7c20b,erpnext/accounts/doctype/item_tax_template/item_tax_template.py,0,1,6,14,20
jeremiah-c-leary/vhdl-style-guide,ad87ea65ee434bed3e643cfc78ded2c0ec174dfe,vsg/rules/report_statement/rule_500.py,0,1,1,1,2
frappe/erpnext,494bd9ef78313436f0424b918f200dab8fc7c20b,erpnext/patches/v10_0/set_currency_in_pricing_rule.py,0,1,3,5,8
wagtail/wagtail,d10f15e55806c6944827d801cd9c2d53f5da4186,wagtail/sites/forms.py,0,1,4,5,9
jeremiah-c-leary/vhdl-style-guide,ad87ea65ee434bed3e643cfc78ded2c0ec174dfe,vsg/rules/function/rule_017.py,0,1,1,1,2
jeremiah-c-leary/vhdl-style-guide,6820bbc266e7875bf76e015feb0533cebe95ebf0,vsg/rules/instantiation/rule_009.py,0,1,8,9,17
jeremiah-c-leary/vhdl-style-guide,ad87ea65ee434bed3e643cfc78ded2c0ec174dfe,vsg/rules/instantiation/rule_009.py,0,1,1,1,2
reclosedev/requests-cache,f41116c5fcccaf87e84582ceeff22f7684e0d607,requests_cache/backends/redis.py,1,3,1,10,11
reclosedev/requests-cache,bacf3aada5f73c289aa37113f2776ac3340995d4,requests_cache/backends/redis.py,0,2,5,20,25
reclosedev/requests-cache,d6ee9143965d53dae44ca3a98802b2cc7ad6eeb7,requests_cache/backends/redis.py,0,1,61,0,61
jeremiah-c-leary/vhdl-style-guide,ad87ea65ee434bed3e643cfc78ded2c0ec174dfe,vsg/rules/block/rule_205.py,0,1,1,1,2
lilydjwg/nvchecker,7739f5c8c0a66cbd131dfc3a0fd8759a9f1d2710,nvchecker_source/sparkle.py,0,1,2,21,23
valohai/valohai-cli,49611346419bde7e4ea5de7923547ea806d1b40b,valohai_cli/commands/execution/logs.py,0,3,6,11,17
valohai/valohai-cli,8f1afc30d496eba00a82a812954433663adb15d2,valohai_cli/commands/execution/logs.py,0,1,11,7,18
ewels/MultiQC,fc65e7f83c2a13cf6767cd9ca8988fbcaee61ea1,multiqc/__main__.py,1,1,32,7,39
jeremiah-c-leary/vhdl-style-guide,ad87ea65ee434bed3e643cfc78ded2c0ec174dfe,vsg/rules/procedure_call/rule_500.py,0,1,1,1,2
wagtail/wagtail,d10f15e55806c6944827d801cd9c2d53f5da4186,wagtail/admin/views/pages/utils.py,0,1,3,5,8
xupingmao/xnote,9901bbb3eaaf00a699198fedebfac04bd27430b6,app.py,0,14,46,74,120
xupingmao/xnote,d0884fbdfc3d0e7073f5f2812f0ca0134b65074c,app.py,0,4,4,10,14
oceanobservatories/mi-instrument,a882a3d7b4a798209a86eda61f1c7d291ad95465,mi/dataset/driver/dofst_k/wfp/dofst_k_wfp_telemetered_driver.py,2,5,15,36,51
frappe/erpnext,494bd9ef78313436f0424b918f200dab8fc7c20b,erpnext/crm/report/lost_opportunity/lost_opportunity.py,0,5,19,25,44
UrLab/DocHub,460ef47e8f76c1d1bae35ce45fbd05ac60dc347e,tags/migrations/0001_initial.py,0,1,7,13,20
jeremiah-c-leary/vhdl-style-guide,ad87ea65ee434bed3e643cfc78ded2c0ec174dfe,vsg/rules/port/rule_009.py,0,1,1,1,2
kiwix/kiwix-build,b7a3187b454dae11e9ac93dcc8788f48f95c01cd,kiwixbuild/dependencies/zstd.py,0,1,3,3,6
Splawik/pytigon,b5222b381ef97984b7383e222bc6e721260f3c5e,pytigon/schserw/schsys/management/commands/createautouser.py,0,1,6,13,19
jeremiah-c-leary/vhdl-style-guide,ad87ea65ee434bed3e643cfc78ded2c0ec174dfe,vsg/rules/generic_map/rule_004.py,0,1,1,1,2
jeremiah-c-leary/vhdl-style-guide,ad87ea65ee434bed3e643cfc78ded2c0ec174dfe,vsg/rules/process/rule_600.py,0,1,1,1,2
jeremiah-c-leary/vhdl-style-guide,ad87ea65ee434bed3e643cfc78ded2c0ec174dfe,vsg/rules/architecture/rule_028.py,0,1,1,1,2
jeremiah-c-leary/vhdl-style-guide,ad87ea65ee434bed3e643cfc78ded2c0ec174dfe,vsg/rules/case/rule_010.py,0,1,1,1,2
hail-is/hail,ed293ee6b171738fc33a638b2e03dbdda337b545,hail/python/hail/backend/backend.py,0,2,545,0,545
hail-is/hail,64f9f86757da3cc5bd67b975e561f5a98d46a4bb,hail/python/hail/backend/backend.py,0,2,2,9,11
StellarCN/py-stellar-base,6850e0fec38a7c5c0e2eccc1f21c913f63857301,stellar_sdk/xdr/inflation_result_code.py,0,2,8,0,8
DemocracyClub/UK-Polling-Stations,acd0d41227c527b06d847479749daca5ac2e0d8a,polling_stations/apps/data_importers/management/commands/import_woking.py,0,1,7,11,18
pythonprobr/pythonpro-website,bd441859a8ff1212a657586d293357be5042a833,pythonpro/core/admin.py,1,2,1,10,11
xupingmao/xnote,fffade65abdd1f8ab1de3ffa6a80eae7f6e482b0,handlers/system/system_info.py,2,2,14,27,41
frappe/erpnext,494bd9ef78313436f0424b918f200dab8fc7c20b,erpnext/manufacturing/report/bom_variance_report/bom_variance_report.py,0,1,67,68,135
fja05680/pinkfish,b875daec838d5101f01b57872a0d22c13ed1e6e3,examples/090.sma-percent-band/strategy.py,0,3,8,1,9
fja05680/pinkfish,b875daec838d5101f01b57872a0d22c13ed1e6e3,examples/180.momentum/strategy.py,0,4,9,4,13
jeremiah-c-leary/vhdl-style-guide,ad87ea65ee434bed3e643cfc78ded2c0ec174dfe,vsg/rules/case/rule_014.py,0,1,1,1,2
facebook/fbthrift,faf9c2ffa5ae444b3e7a4836c87198b0c82f3838,thrift/lib/py/protocol/exceptions.py,0,1,2,5,7
googleapis/google-cloud-php,b22e26db76cf956f865a16aad4320befacee8cc7,Asset/owlbot.py,0,2,26,0,26
helfertool/helfertool,eb47e6df3416883df8f07f137494e2f351f7f300,src/registration/migrations/0055_event_corona.py,0,1,4,6,10
ray-project/ray,35028182f0c4f4c3b3695b9a7608f18ed36868a4,python/ray/autoscaler/_private/resource_demand_scheduler.py,0,4,28,18,46
mitmproxy/mitmproxy,b3587b52b25077f68116b9852b041d33e7fc6601,mitmproxy/io/io.py,0,3,5,7,12
mapillary/OpenSfM,9f2cfe6fb04118a733b57f72f74a30e1f72a5aaf,opensfm/mesh.py,0,1,32,33,65
mapillary/OpenSfM,15929d6d8ec6a69a46511f14b4862daafbd15c9a,opensfm/mesh.py,0,6,8,30,38
jeremiah-c-leary/vhdl-style-guide,ad87ea65ee434bed3e643cfc78ded2c0ec174dfe,vsg/rules/architecture/rule_009.py,0,1,1,1,2
ganga-devs/ganga,00968e14f2c3801afb2df54b6baf185f0eb068b6,ganga/GangaLHCb/Lib/Applications/Ostap.py,0,9,124,129,253
jeremiah-c-leary/vhdl-style-guide,ad87ea65ee434bed3e643cfc78ded2c0ec174dfe,vsg/rules/signal/rule_004.py,0,1,1,1,2
hasgeek/funnel,ec0f1cd6633bfeae18dc227dcd0c34018d96d767,funnel/loginproviders/github.py,0,3,5,10,15
CompassionCH/compassion-switzerland,9f516fc8500192deafd63293fe5712de572aef68,partner_communication_switzerland/models/partner_communication_config.py,1,1,3,13,16
astropy/astropy,19ca7d290f2e6486dfba77d510702545f4318389,astropy/units/physical.py,0,1,7,3,10
StellarCN/py-stellar-base,6850e0fec38a7c5c0e2eccc1f21c913f63857301,stellar_sdk/xdr/operation_type.py,0,2,8,0,8
StellarCN/py-stellar-base,6850e0fec38a7c5c0e2eccc1f21c913f63857301,stellar_sdk/xdr/create_account_result_code.py,0,2,8,0,8
StellarCN/py-stellar-base,6850e0fec38a7c5c0e2eccc1f21c913f63857301,stellar_sdk/xdr/ledger_entry_type.py,0,2,8,0,8
jeremiah-c-leary/vhdl-style-guide,328b8b336cf09c66130ad433eb929233ba020491,vsg/rules/context/rule_004.py,0,1,55,4,59
jeremiah-c-leary/vhdl-style-guide,ad87ea65ee434bed3e643cfc78ded2c0ec174dfe,vsg/rules/context/rule_004.py,0,1,1,1,2
jeremiah-c-leary/vhdl-style-guide,ad87ea65ee434bed3e643cfc78ded2c0ec174dfe,vsg/rules/component/rule_014.py,0,1,1,1,2
fkie-cad/FACT_core,1dc27f9b3b3e5720badcefded26ac7768f8d7e4d,src/plugins/analysis/crypto_hints/code/crypto_hints.py,0,1,3,0,3
ECP-CANDLE/Benchmarks,8cc5e04b8a54060de8a707f9a6dd25f1ddd10db5,common/clr_keras_utils.py,0,6,55,59,114
Tuxemon/Tuxemon,2ee8582a84aa7515dcf94e10d712dec7ba3a4bdb,tuxemon/mod_manager/tuxemoncontentserver.py,0,5,10,49,59
Tuxemon/Tuxemon,2ee8582a84aa7515dcf94e10d712dec7ba3a4bdb,tuxemon/event/actions/play_music.py,0,1,1,3,4
frappe/erpnext,494bd9ef78313436f0424b918f200dab8fc7c20b,erpnext/accounts/doctype/pos_opening_entry/pos_opening_entry.py,0,2,3,8,11
MarxMustermann/OfMiceAndMechs,e8b491aed5dacac50aac22884291eca7d5978514,src/itemFolder/industry/scrapCompactor.py,0,10,51,101,152
MarxMustermann/OfMiceAndMechs,b0e6c279d7d5e4fb1bf66bc6d6c5e194fd4df5b0,src/itemFolder/industry/scrapCompactor.py,0,1,2,1,3
pantsbuild/pants,096b135b0b19f9425d97b1f77afb521f5b8584b5,src/python/pants/backend/python/subsystems/python_native_code.py,0,4,30,23,53
pantsbuild/pants,7e31f4b7fab5b42e55820d6de221d69a5a51596c,src/python/pants/backend/python/subsystems/python_native_code.py,0,2,27,13,40
cobbler/cobbler,d5cd6f054d62fa5fc3d03bed13abbf0649e26977,cobbler/download_manager.py,0,1,4,3,7
StellarCN/py-stellar-base,6850e0fec38a7c5c0e2eccc1f21c913f63857301,stellar_sdk/xdr/claim_predicate_type.py,0,2,8,0,8
Alexey-T/CudaText,9eed9bdea80797b5a1739ee11a48e213e8debf22,app/py/sys/requests/adapters.py,0,21,89,140,229
StellarCN/py-stellar-base,6850e0fec38a7c5c0e2eccc1f21c913f63857301,stellar_sdk/xdr/end_sponsoring_future_reserves_result_code.py,0,2,8,0,8
jeremiah-c-leary/vhdl-style-guide,ad87ea65ee434bed3e643cfc78ded2c0ec174dfe,vsg/rules/if_statement/rule_027.py,0,1,1,1,2
jeremiah-c-leary/vhdl-style-guide,c117fa55f6056fc1ac97f55c13c51308545a7ddc,vsg/rules/architecture/rule_003.py,0,1,3,3,6
jeremiah-c-leary/vhdl-style-guide,a820c8a30f36c3a6dfe40245047e2c789de75711,vsg/rules/architecture/rule_003.py,0,1,1,1,2
opendata-swiss/ckanext-geocat,a01bba80d6e770958a59cda7f2f66b0f298b3976,ckanext/geocat/utils/search_utils.py,0,1,1,2,3
jeremiah-c-leary/vhdl-style-guide,ad87ea65ee434bed3e643cfc78ded2c0ec174dfe,vsg/rules/package_body/rule_600.py,0,1,1,1,2
explosion/thinc,f6eee9a810190d14770eb1f31072e4e09c76a10a,thinc/layers/residual.py,0,1,2,3,5
frappe/erpnext,494bd9ef78313436f0424b918f200dab8fc7c20b,erpnext/patches/v12_0/stock_entry_enhancements.py,0,2,19,35,54
MozillaSecurity/FuzzManager,bb12ebd389864bbba8c2c9e15ab808efae54e660,server/crashmanager/migrations/0004_bugzillatemplate_mode.py,0,1,9,9,18
Splawik/pytigon,b5222b381ef97984b7383e222bc6e721260f3c5e,pytigon/schserw/schsys/initdjango.py,0,6,16,28,44
MozillaSecurity/FuzzManager,bb12ebd389864bbba8c2c9e15ab808efae54e660,server/covmanager/migrations/0003_collection_file_optional.py,0,1,5,9,14
StellarCN/py-stellar-base,6850e0fec38a7c5c0e2eccc1f21c913f63857301,stellar_sdk/xdr/claimant_type.py,0,2,8,0,8
jeremiah-c-leary/vhdl-style-guide,ad87ea65ee434bed3e643cfc78ded2c0ec174dfe,vsg/rules/process/rule_013.py,0,1,1,1,2
ECP-CANDLE/Benchmarks,8cc5e04b8a54060de8a707f9a6dd25f1ddd10db5,examples/image-vae/dataloader.py,0,3,12,20,32
litex-hub/litex-boards,3f58df99749c24b19f7769326ff0a5865c50dcb2,litex_boards/targets/digilent_zedboard.py,0,1,2,6,8
pydoit/doit,87e923a7dfb7e9c2fcbec8297afd915e2641266c,doit/cmd_run.py,0,10,27,26,53
jeremiah-c-leary/vhdl-style-guide,ad87ea65ee434bed3e643cfc78ded2c0ec174dfe,vsg/rules/package/rule_018.py,0,1,1,1,2
jeremiah-c-leary/vhdl-style-guide,ad87ea65ee434bed3e643cfc78ded2c0ec174dfe,vsg/rules/report_statement/rule_501.py,0,1,1,1,2
helfertool/helfertool,eb47e6df3416883df8f07f137494e2f351f7f300,src/registration/migrations/0003_auto_20160323_1539.py,0,1,4,9,13
googlefonts/nanoemoji,d1dd1b463fafcfcdc9e1691354f0b4d5bc93e879,src/nanoemoji/write_font.py,1,7,18,25,43
googlefonts/nanoemoji,e248dc4ab8df2c73a269f2a6e932aa5d1701e081,src/nanoemoji/write_font.py,1,8,20,26,46
googlefonts/nanoemoji,335f056d1c0da6b191bf0d05f1b26c04c8559d0a,src/nanoemoji/write_font.py,0,1,17,0,17
googlefonts/nanoemoji,6d34eda2b167b1abc357ffa708a1224e9b4f344c,src/nanoemoji/write_font.py,1,13,184,95,279
googlefonts/nanoemoji,ac8e759311a7216d3c0d05e50f17a56e1b81a93a,src/nanoemoji/write_font.py,0,3,34,9,43
streamlink/streamlink,48f89595aa8a853801ac1ab9adca2e105f35d88d,src/streamlink/plugins/cdnbg.py,0,2,18,39,57
streamlink/streamlink,561993d2b725ebdc643526420149185607e08aa4,src/streamlink/plugins/cdnbg.py,1,2,42,61,103
UtrechtUniversity/yoda-portal,730e931440f028a8c5f0be80078e6f443f1fc644,stats/stats.py,0,0,0,0,0
UtrechtUniversity/yoda-portal,882e87577d00b57cc6facdc614953e8cbcfe29c1,stats/stats.py,0,1,3,3,6
jeremiah-c-leary/vhdl-style-guide,ad87ea65ee434bed3e643cfc78ded2c0ec174dfe,vsg/rules/port_map/rule_004.py,0,1,1,1,2
diofant/diofant,bd5d18ebeecfb60a793b7bcccaad0646acc16bba,diofant/polys/groebnertools.py,0,1,2,4,6
leprikon-cz/leprikon,962be36f3d3e957e4326cabae8f1cafdbc36f852,leprikon/middleware.py,0,1,2,3,5
jeremiah-c-leary/vhdl-style-guide,ad87ea65ee434bed3e643cfc78ded2c0ec174dfe,vsg/rules/generate/rule_017.py,0,1,1,1,2
demisto/content,80c8b278afc0928336f45f94d75a22e32f819166,Packs/QRadar/Scripts/QRadarPrintEvents/QRadarPrintEvents.py,0,1,5,6,11
wagtail/wagtail,d10f15e55806c6944827d801cd9c2d53f5da4186,wagtail/admin/urls/password_reset.py,0,1,8,10,18
wagtail/wagtail,d10f15e55806c6944827d801cd9c2d53f5da4186,wagtail/contrib/simple_translation/migrations/0001_initial.py,0,1,6,13,19
jeremiah-c-leary/vhdl-style-guide,ad87ea65ee434bed3e643cfc78ded2c0ec174dfe,vsg/rules/subtype/rule_600.py,0,1,1,1,2
aaugustin/websockets,c4a4b6f45af607431c5707d56420bbaf471bbb6e,src/websockets/legacy/protocol.py,0,3,8,14,22
jeremiah-c-leary/vhdl-style-guide,c203f3bc64b77dccedbc339a2c7805ea5db5cc9d,vsg/rules/architecture/rule_032.py,0,2,4,7,11
helfertool/helfertool,eb47e6df3416883df8f07f137494e2f351f7f300,src/registration/migrations/0020_event_logo_social.py,0,1,4,10,14
jeremiah-c-leary/vhdl-style-guide,ad87ea65ee434bed3e643cfc78ded2c0ec174dfe,vsg/rules/type_definition/rule_002.py,0,1,1,1,2
FDio/vpp,d9b0c6fbf7aa5bd9af84264105b39c82028a4a29,src/plugins/nat/extras/nat_1Ms.py,0,1,10,14,24
vortex-exoplanet/VIP,1bc8389bc4f1904e195d3c8e45a6b5f5ff0d3e3d,vip_hci/stats/distances.py,0,2,126,10,136
vortex-exoplanet/VIP,d05486032b4462b15ae067757a3cedfc8b46a7e3,vip_hci/stats/distances.py,0,4,41,48,89
StellarCN/py-stellar-base,6850e0fec38a7c5c0e2eccc1f21c913f63857301,stellar_sdk/xdr/revoke_sponsorship_result_code.py,0,2,8,0,8
jeremiah-c-leary/vhdl-style-guide,acb0c44b71ed3e4182757d2f593f29cf61630e6e,vsg/rules/function/rule_005.py,0,1,3,4,7
jeremiah-c-leary/vhdl-style-guide,ad87ea65ee434bed3e643cfc78ded2c0ec174dfe,vsg/rules/function/rule_005.py,0,1,1,1,2
Tuxemon/Tuxemon,2ee8582a84aa7515dcf94e10d712dec7ba3a4bdb,tuxemon/log.py,0,1,1,5,6
Splawik/pytigon,b5222b381ef97984b7383e222bc6e721260f3c5e,pytigon/manage.py,0,2,5,13,18
frappe/erpnext,494bd9ef78313436f0424b918f200dab8fc7c20b,erpnext/patches/v11_1/set_default_action_for_quality_inspection.py,0,1,8,10,18
dpressel/baseline,746fcf5fc8ec939094fb4f50939e15eddd7428df,mead/api_examples/lm_text.py,0,1,5,0,5
helfertool/helfertool,230b084a0fab8940e129f50c85ab78f474267e37,src/mail/views/send_mail.py,0,2,2,2,4
StellarCN/py-stellar-base,6850e0fec38a7c5c0e2eccc1f21c913f63857301,stellar_sdk/xdr/public_key_type.py,0,2,8,0,8
jeremiah-c-leary/vhdl-style-guide,ad87ea65ee434bed3e643cfc78ded2c0ec174dfe,vsg/rules/block/rule_203.py,0,1,1,1,2
pekrau/Publications,e998977e05ddc6937de9ee6f8229c3661b219614,publications/home.py,0,2,15,26,41
radiasoft/sirepo,c50b73641dea44f71c6e8ee66af64f94075b549c,sirepo/sim_data/controls.py,3,9,34,49,83
jeremiah-c-leary/vhdl-style-guide,ad87ea65ee434bed3e643cfc78ded2c0ec174dfe,vsg/rules/generate/rule_010.py,0,1,1,1,2
jeremiah-c-leary/vhdl-style-guide,7225df8b9db9eb5b210c8b41597ad1d64eed5c3b,vsg/vhdlFile/classify/interface_file_declaration.py,0,1,1,1,2
jeremiah-c-leary/vhdl-style-guide,ad87ea65ee434bed3e643cfc78ded2c0ec174dfe,vsg/rules/if_statement/rule_028.py,0,1,1,1,2
jeremiah-c-leary/vhdl-style-guide,ad87ea65ee434bed3e643cfc78ded2c0ec174dfe,vsg/rules/package/rule_011.py,0,1,1,1,2
bukun/TorCMS,794c75cdba2a77e7e0dbdbc1b9a1860b6bcab9c4,router.py,0,1,2,1,3
wagtail/wagtail,d10f15e55806c6944827d801cd9c2d53f5da4186,wagtail/images/migrations/0014_add_filter_spec_field.py,0,1,7,15,22
cobbler/cobbler,0b1a9e804fc9e2353096b485ac08656fbec3cc7b,cobbler/settings/migrations/V2_8_5.py,0,1,111,119,230
jeremiah-c-leary/vhdl-style-guide,ad87ea65ee434bed3e643cfc78ded2c0ec174dfe,vsg/rules/package/rule_004.py,0,1,1,1,2
wagtail/wagtail,d10f15e55806c6944827d801cd9c2d53f5da4186,wagtail/documents/migrations/0002_initial_data.py,0,1,22,26,48
jeremiah-c-leary/vhdl-style-guide,ad87ea65ee434bed3e643cfc78ded2c0ec174dfe,vsg/rules/type_definition/rule_600.py,0,1,1,1,2
frappe/erpnext,494bd9ef78313436f0424b918f200dab8fc7c20b,erpnext/patches/v12_0/repost_stock_ledger_entries_for_target_warehouse.py,0,2,19,51,70
jeremiah-c-leary/vhdl-style-guide,a95bd0487335334a5da2850a543e404412d6ed0a,vsg/rules/context/rule_026.py,0,2,4,5,9
jeremiah-c-leary/vhdl-style-guide,7c2c21aab1b9a478274c174bbd387b9ba71f52d7,vsg/rules/context/rule_026.py,0,1,24,6,30
jeremiah-c-leary/vhdl-style-guide,ad87ea65ee434bed3e643cfc78ded2c0ec174dfe,vsg/rules/context_ref/rule_003.py,0,1,1,1,2
jeremiah-c-leary/vhdl-style-guide,ad87ea65ee434bed3e643cfc78ded2c0ec174dfe,vsg/rules/block/rule_504.py,0,1,1,1,2
frappe/erpnext,494bd9ef78313436f0424b918f200dab8fc7c20b,erpnext/patches/v13_0/update_returned_qty_in_pr_dn.py,0,2,9,13,22
jeremiah-c-leary/vhdl-style-guide,ad87ea65ee434bed3e643cfc78ded2c0ec174dfe,vsg/rules/context/rule_012.py,0,1,1,1,2
kbase/narrative,835b605cb6b80acd63c11074391a13e2a70c0cbc,src/biokbase/narrative/jobs/util.py,0,1,34,0,34
GPflow/GPflow,78230b98f57c64b5ee2932ea0d2752eb9ff102ce,gpflow/kernels/convolutional.py,0,3,5,7,12
fabiocaccamo/django-admin-interface,c253617346d67d58ed06b0f672ad059d2a2f5832,admin_interface/models.py,0,4,52,104,156
fabiocaccamo/django-admin-interface,e64614274c59d58d14e0d2c2946cc1fc7c35ddd5,admin_interface/models.py,0,2,149,199,348
fabiocaccamo/django-admin-interface,4deefc20b7123e5feab170826b6bbdfd3ea09539,admin_interface/models.py,0,1,1,2,3
jobovy/galpy,abb6577adf5ae9fd34bb2f7f8c7965d545ae7aef,doc/source/examples/dierickx-edist.py,0,3,9,14,23
mongodb/mongo-python-driver,5578999a90e439fbca06fc0ffc98f4d04e96f7b4,bson/binary.py,0,8,24,34,58
jeremiah-c-leary/vhdl-style-guide,ad87ea65ee434bed3e643cfc78ded2c0ec174dfe,vsg/rules/package/rule_008.py,0,1,1,1,2
jeremiah-c-leary/vhdl-style-guide,c203f3bc64b77dccedbc339a2c7805ea5db5cc9d,vsg/rules/context/rule_002.py,0,2,4,7,11
jeremiah-c-leary/vhdl-style-guide,ad87ea65ee434bed3e643cfc78ded2c0ec174dfe,vsg/rules/architecture/rule_200.py,0,1,1,1,2
jeremiah-c-leary/vhdl-style-guide,0ea8dd34070d3bfc7be175068512e40714436da6,vsg/rules/library/rule_007.py,0,1,4,4,8
jeremiah-c-leary/vhdl-style-guide,ad87ea65ee434bed3e643cfc78ded2c0ec174dfe,vsg/rules/library/rule_007.py,0,1,1,1,2
MIT-LCP/wfdb-python,3b408f23f50889c7d1c6fee9329c76b739b9f667,wfdb/io/download.py,0,18,41,67,108
jeremiah-c-leary/vhdl-style-guide,ad87ea65ee434bed3e643cfc78ded2c0ec174dfe,vsg/rules/case/rule_017.py,0,1,1,1,2
frappe/erpnext,494bd9ef78313436f0424b918f200dab8fc7c20b,erpnext/patches/v14_0/rename_ongoing_status_in_sla_documents.py,0,1,13,7,20
gemrb/gemrb,d0db464e53eb5a61d13e03596e2c5edb529e82bf,gemrb/GUIScripts/demo/MessageWindow.py,0,1,4,4,8
jeremiah-c-leary/vhdl-style-guide,985ea8da9c7d1d78aa2baf4261bb236d043da0ec,vsg/rules/architecture/rule_011.py,1,1,40,7,47
jeremiah-c-leary/vhdl-style-guide,ad87ea65ee434bed3e643cfc78ded2c0ec174dfe,vsg/rules/architecture/rule_011.py,0,1,1,1,2
google-research/kubric,6060a367e88b68cd3dc90caee7b84a7e30993e19,kubric/renderer/blender_utils.py,0,3,19,23,42
google-research/kubric,61af8e7b871d23245a0f726c79a5950d70ec028d,kubric/renderer/blender_utils.py,0,5,17,21,38
MozillaSecurity/FuzzManager,bb12ebd389864bbba8c2c9e15ab808efae54e660,misc/ec2prices/simulations/choose_once.py,0,3,4,7,11
helfertool/helfertool,eb47e6df3416883df8f07f137494e2f351f7f300,src/registration/migrations/0054_alter_event_url_name.py,0,1,4,13,17
hasgeek/funnel,75d29f58ddb90f9afb11a03c705d27e710d18adb,funnel/models/contact_exchange.py,0,2,7,8,15
hasgeek/funnel,6997b117c9a09fdefa03c92117138c6a8c44751a,funnel/models/contact_exchange.py,0,6,6,12,18
DemocracyClub/UK-Polling-Stations,d11e29b16b1e80d70af499621f4247ab765aedf2,polling_stations/apps/data_importers/management/commands/import_bradford.py,0,1,64,22,86
hail-is/hail,e657e712d6dd295805743dc5fca0d006ac150922,hail/python/hailtop/auth/tokens.py,0,4,4,11,15
jeremiah-c-leary/vhdl-style-guide,ad87ea65ee434bed3e643cfc78ded2c0ec174dfe,vsg/rules/if_statement/rule_029.py,0,1,1,1,2
hasgeek/funnel,6997b117c9a09fdefa03c92117138c6a8c44751a,funnel/views/video.py,0,2,2,6,8
wagtail/wagtail,d10f15e55806c6944827d801cd9c2d53f5da4186,wagtail/admin/views/generic/models.py,0,14,42,60,102
astropy/astropy,cefd6c9db6fa919e031a1d642daa282bc6d1c8d8,astropy/modeling/bounding_box.py,0,6,9,10,19
mozman/ezdxf,0955db2488b8957bf3d85b1f02c775e40ffd84ec,src/ezdxf/addons/odafc.py,0,11,36,59,95
mozman/ezdxf,71ab0c90609819aec4806e4960a536e904e3f7c4,src/ezdxf/addons/odafc.py,3,5,5,88,93
idaholab/raven,cb6fb8f366fa457395d1d2e5f6acd451440c6fee,doc/user_manual/generated/generateRomDoc.py,0,2,6,6,12
radiasoft/sirepo,48eb6a685f43ac18e8bb6184cd689455e6040331,sirepo/uri_router.py,0,18,69,91,160
radiasoft/sirepo,48eb6a685f43ac18e8bb6184cd689455e6040331,sirepo/util.py,0,20,74,69,143
frappe/erpnext,494bd9ef78313436f0424b918f200dab8fc7c20b,erpnext/accounts/doctype/cashier_closing/cashier_closing.py,0,2,3,8,11
jumpserver/jumpserver,10295569025b12b054e7692deda55105d1e07283,apps/settings/serializers/auth/wecom.py,0,1,2,4,6
calico/basenji,f6bcce204042e2201fca214f5314e2972462a0d0,basenji/gene.py,0,0,0,0,0
OstapHEP/ostap,5e6d7df898a971946faf4091f9524de3d6020ca3,ostap/utils/source_env.py,0,8,11,11,22
googleapis/python-logging,e3cac888d40bf67af11e57b74615b0c3b8e8aa3e,google/cloud/logging_v2/handlers/handlers.py,0,4,13,14,27
jeremiah-c-leary/vhdl-style-guide,c203f3bc64b77dccedbc339a2c7805ea5db5cc9d,vsg/rules/component/rule_007.py,0,2,4,7,11
tensorflow/datasets,b25e2a27cfb630bec387b30d71510c350d6d9b48,tensorflow_datasets/core/utils/type_utils.py,0,2,249,1,250
jeremiah-c-leary/vhdl-style-guide,ad87ea65ee434bed3e643cfc78ded2c0ec174dfe,vsg/rules/block/rule_506.py,0,1,1,1,2
StellarCN/py-stellar-base,6850e0fec38a7c5c0e2eccc1f21c913f63857301,stellar_sdk/xdr/claimable_balance_flags.py,0,2,8,0,8
jeremiah-c-leary/vhdl-style-guide,ad87ea65ee434bed3e643cfc78ded2c0ec174dfe,vsg/rules/generic/rule_009.py,0,1,1,1,2
opendata-swiss/ckanext-geocat,a01bba80d6e770958a59cda7f2f66b0f298b3976,ckanext/geocat/harvester.py,0,2,2,8,10
oss/shrunk,ebab862464a95fac8d784c18f64444c10881080e,backend/shrunk/client/exceptions.py,1,2,1,11,12
catalyst-cooperative/pudl,431c5873674cf184dc4f4f464df59dbb4fa4d894,src/pudl/output/ferc1.py,0,10,87,145,232
catalyst-cooperative/pudl,b4fdf6d57259b1def67db3b816fddccdacd81868,src/pudl/output/ferc1.py,1,10,38,40,78
catalyst-cooperative/pudl,d4fd3481450e6db2a05203253c8f6fd05f3ea07f,src/pudl/output/ferc1.py,31,17,329,811,1140
catalyst-cooperative/pudl,8a242a39ca316d9d62381fcf3ec2b114fff6a9b8,src/pudl/output/ferc1.py,0,2,87,0,87
catalyst-cooperative/pudl,e4e4095f587c7b2e91daad9fc815a78918c82068,src/pudl/output/ferc1.py,0,10,151,31,182
catalyst-cooperative/pudl,8e30578195b8d9d3c5586fe696fdc044b4632bec,src/pudl/output/ferc1.py,0,3,3,0,3
catalyst-cooperative/pudl,ec7bf0e5e7a872e0216c27b8c21184d0d703c6d4,src/pudl/output/ferc1.py,0,16,192,44,236
catalyst-cooperative/pudl,43c51e16967d74f42bdc94b182aeba107fbc0d6b,src/pudl/output/ferc1.py,0,2,3,7,10
catalyst-cooperative/pudl,80a3e6dfbe2540af39f986b9fb853f7c245c7a3f,src/pudl/output/ferc1.py,0,5,24,32,56
frappe/erpnext,494bd9ef78313436f0424b918f200dab8fc7c20b,erpnext/selling/report/pending_so_items_for_purchase_request/pending_so_items_for_purchase_request.py,0,3,86,50,136
python-attrs/cattrs,a6ab50318a98424ebdf482690f5982f024a3512c,src/cattr/errors.py,0,1,8,2,10
MozillaSecurity/FuzzManager,bb12ebd389864bbba8c2c9e15ab808efae54e660,server/server/middleware.py,0,3,6,13,19
helfertool/helfertool,eb47e6df3416883df8f07f137494e2f351f7f300,src/registration/migrations/0004_auto_20160323_1600.py,0,1,4,9,13
radiasoft/sirepo,2c756d108fc7d5f431d66526072ce125c411998a,sirepo/template/code_variable.py,0,12,19,53,72
radiasoft/sirepo,48eb6a685f43ac18e8bb6184cd689455e6040331,sirepo/template/code_variable.py,0,17,80,98,178
frappe/erpnext,494bd9ef78313436f0424b918f200dab8fc7c20b,erpnext/templates/pages/task_info.py,0,1,3,6,9
jeremiah-c-leary/vhdl-style-guide,a95bd0487335334a5da2850a543e404412d6ed0a,vsg/rules/context/rule_027.py,0,2,4,5,9
jeremiah-c-leary/vhdl-style-guide,7c2c21aab1b9a478274c174bbd387b9ba71f52d7,vsg/rules/context/rule_027.py,0,1,24,6,30
StellarCN/py-stellar-base,6850e0fec38a7c5c0e2eccc1f21c913f63857301,stellar_sdk/xdr/clawback_claimable_balance_result_code.py,0,2,8,0,8
jeremiah-c-leary/vhdl-style-guide,a820c8a30f36c3a6dfe40245047e2c789de75711,vsg/rules/instantiation/rule_004.py,0,1,1,1,2
alphagov/notifications-api,1d157836adca8f8d2ec7953fb984ab9fb5775ae8,app/billing/billing_schemas.py,0,2,6,0,6
plivo/plivo-python,acd35f4d3d63aecdd4ab6efcd0031fef1e8a67a7,plivo/resources/queued_calls.py,0,1,5,21,26
jeremiah-c-leary/vhdl-style-guide,ad87ea65ee434bed3e643cfc78ded2c0ec174dfe,vsg/rules/process/rule_005.py,0,1,1,1,2
DemocracyClub/UK-Polling-Stations,90030c0572984b3679bfd1cd1b4b4e589cabd216,polling_stations/apps/data_importers/management/commands/import_waltham_forest.py,0,2,80,20,100
amccaugh/phidl,0fa5471f078eb9c8da87a9e7e3c95f0dfa4a3097,docs/gen_API.py,0,2,2,3,5
wagtail/wagtail,d10f15e55806c6944827d801cd9c2d53f5da4186,wagtail/admin/localization.py,0,2,123,122,245
radiasoft/sirepo,48eb6a685f43ac18e8bb6184cd689455e6040331,sirepo/template/srw_fixup.py,0,3,24,28,52
jeremiah-c-leary/vhdl-style-guide,a820c8a30f36c3a6dfe40245047e2c789de75711,vsg/rules/function/rule_006.py,0,1,1,1,2
benvanwerkhoven/kernel_tuner,a7405e4fafe57f277b0fd983214c69e0942e6b2d,kernel_tuner/strategies/brute_force.py,0,2,15,5,20
